quality	n. 品质, 特质, 才能 adj. 高品质的
defective	adj. 有缺陷的,欠缺,不完全变化动词 n. 有缺陷的人,不完全变化动词
interpretable	adj.能说明的,能翻译的,可判断的
interest	n. 兴趣, 嗜好, 利息; 股份 vt. 使...感兴趣
fourscore	adj. 八十的 n. 八十
teach	vt. 教,教书,教导，教训 vi. 给予指导
procedural	adj. 程序的 n.警察疑案作品
phrase	n. 短语,习语,个人风格,乐句 vt. 措词表达,将(乐曲)分成乐句(来演奏)
specifically	adv. 特定地,明确地
penalty	n. 处罚,惩罚
violate	vt. 违犯, 亵渎, 干扰, 侵犯, 强奸
indefinitely	adv. 无限地(在长时期内,无穷地)
major	n. 主修, 成年人, 陆军少校; 巨头 adj. 主要的, 较多的, 大部份的 vi. 主修
higher	adj. 更高的
wise	adj. 明智的,有学问的,有智慧的,聪明的 n. 方式 vt. 引导 vi. 学
becoming	adj. 合适的，适当的，好看的 动词become的现在分词形式
equally	adv. 相等地, 同样地, 平等地
enjoy	vt. &vi. 享受,喜欢
forth	adv.向前，向前方； 露着的，往外的； [废语]出外，离家 prep.出自，从…离开
disappear	vi. 消失,灭绝 vt. 引起消失
crop	n. 庄稼,收成, 一群,平头 vt. 割掉, 修剪, 剪短, 收割, 使谷物生长 vi. 啃青草, 种植谷物
diagonally	adv. 斜对地, 对角地
decision	n. 决定,决心
effective	adj. 有效的,有影响的
significant	adj. 有意义的, 意味深长的; 相当数量的; 重要的, 重大的 n. (复)有意义的事物; 标志
avail	vi. 有利 vt. 有用 n. 益处
hang	vt.悬挂； （被）绞死； 贴，装饰； 使悬而未决 vi.悬垂； 被吊死； 附属，依靠； 悬而未决 n.悬挂的样子； （动作的）暂停； 〈口〉大意，要点； 〈口〉做法，诀窍
craze	n. 狂热, 大流行，(陶瓷器等表面的)裂纹 v. (使)发狂, (使)产生裂纹
consequently	adv. 所以, 因此
introduce	vt. 介绍, 引进, 采用, 提出, 提倡, 放入
team	n. 队,组 vt. 协同工作 vi. 结成一队 adj. 团队的
visual	adj. 视觉的 n. 画面, 图象
acknowledgment	n. 承认, 承认书, 感谢 =acknowledgement
efficiently	adv.有效率地,有效地
predict	v. 预知, 预言, 预报
anticipate	vt. 预期，期望；占先，抢先；提前使用
bypass	vt. 绕开, 忽视 n. 支路，旁道
nature	n.自然,自然界,自然状态; 本性,天性,性质; 质; 性格; 性; 本质
natural	adj.自然的； 物质的； 天生的； 不做作的 n.自然的事情； （生来的）白痴； [乐]（风琴等的）白键
grant	vt.承认； 同意； 准许； 授予 n.拨款； 补助金； 授给物（如财产、授地、专有权、补助、拨款等） vi.同意
logarithm	n. [数]对数
reload	v. 再装入
occupy	vt. 占领,占,住进
photograph	n. 相片 vi. 照相,摄影 vt. 给...照相
resolve	n. 决定之事,决心,坚决 vt. 决定,解决,分离,表决 vi. 分离,决定
unsafe	adj. 不安全的, 不安稳的, 危险的
separator	n. 分隔符，分离器
hierarchical	adj. 按等级划分的
assortment	n. 分类, 配合, 各色俱备之物
growing	adj. 发展的, 扩大的
discussion	n. 讨论 v. 讨论,商议
alphabet	n. 字母表,基本原理(元素)，符号系统
scattered	adj. 分散的，稀疏的
eventually	adv. 终于, 最后
finally	adv. 最后, 最终
subgroup	n. 隶属组织
superimpose	vt. 重叠(安装,添加)
reorganization	n. 改组, 再编制, 改造
rewrite	n. 重写, 改写 vt. 改写, 重写 vi. 修改
university	n. 大学
deter	v. 制止,使...断念
pool	n. 水塘(池),游泳池,撞球 vi. 形成池塘 vt. 集中,积累
moment	n. 片刻，瞬间，准确时刻，非常重要的时机，力矩
shut	adj. 关闭的,合拢的,围绕的 vt. 关上，防止进入，禁闭，合上，停止或中止 vi. 关闭，停止或中止 n. 关闭
closed	adj. 关闭的, 封闭的, 停业的 动词close的过去式和过去分词
respond	vi. &vt. 回复,反应，响应，应答 n. 拱柱
repeating	adj. 重复的, 反复的 动词repeat的现在分词形式
repetitive	adj. 重复的
reenter	v. 重新进入
rearrange	重新整理, 重新排序
rectangular	adj. 矩形的；成直角的
tag	n. 标签,附属物,名称,谚语 vt. 附以签条,尾随,添饰,指责,连接 vi. 紧随,尾随
suppose	vt.假定； 猜想，推测； 认为； 让（用于祈祷语气） vi.想象，猜想
supposed	adj. 想象上的，假定的
operator	n. 操作员,管理者,技工,报务员
masking	n. 遮蔽 动词mask的现在分词形式
price	n. 价格,代价,价值 vt. 定格,标价,比较价格
demonstrate	vt. 示范, 演示, 证明 vi. 示威
importance	n. 重要,重要性
pipe	n. 管,烟斗,笛 vt. 以管输送,装管道,吹奏,尖声说,拷边 vi. 吹奏管乐,尖叫
overall	adj. 全部的, 全体的, 一切在内的 adv. 总的来说, 全部地 n. 防护服，罩衫
turnkey	n. 监狱的看守, 狱吏 adj. 即可使用的
restricted	vt. 限制,约束 adj. 受限制的,有限的,保密的
suspension	n. 悬挂,悬浮液,暂缓,未决,中止
seamless	无缝的
clipper	n. 剪削者，大剪刀，理发剪 n. （十九世纪的）快速帆船 n. 快马
unsigned	adj. 未签署的，无符号的
unformatted	adj. 无格式的
infinite	adj. 无限的,无穷的 n. 无限
useless	adj. 无用的，无效的
mountain	n. 山,山脉,大量
redundant	adj. 多余的,失业的
dependent	adj. 附属的,依赖的,悬垂的 n. 受经济援助者
background	n. 背景,幕后,配音 vt. 提供背景
product	n. 产品,成果,乘积
assignment	n. 分配,功课,任务,被指定的(课外)作业;(分派的)任务, 委派
bad	adj. 坏的,令人不满意的,有害的,有病的 n. 坏人,坏事
declare	vt. &vi. 宣布,声明,申报
adjust	vt. 调整, 使...适于 vi. 适应
recognize	vt. 认出,认可,承认,意识到,表示感激
route	n. 航线,路线,途径 vt. 按路线发送, 改变路线
respectively	adv. 各自地, 分别地
unsuccessful	adj. 不成功的, 失败的
received	adj. 被一般承认的,公认的
navigate	vi. 航行,驾驶,操纵 vt. 航行,驾驶
considered	adj.考虑过的,被尊重的
due	adj.由于； 适当的； 预定； 到期 n.应有的权利； 应得到的东西； 应缴款 adv.正向； 正对着
recently	adv. 最近
room	房间, 空间
descend	vt. &vi. 降,传,降临
archive	n. 档案,档案馆 vt. 存档