contiguous	adj. 邻近的,接触的,连续的
consistent	adj. 始终如一的, 一致的, 坚持的
multiprocessing	n. 多重处理, 多处理技术
architecture	n. 建筑学, 建筑业, 建筑物, 结构 [总称]建筑物, 建筑风格
structural	adj. 结构的, 构造的，建筑的，建筑用的
outcome	n. 结果
association	n. 联合,结合,交往,协会,社团,联想
opinion	n. 看法,意见 v. 判断,意见,主张
interpret	v. 解释, 演出, 翻译 [计算机] 解释
explanatory	adj. 说明的, 解释的
assemble	vt. 聚集,集合,装配 vi. 集合, 聚集
assembler	n. 装配工 n. [计]汇编程序
cad	n. 卑鄙的男人，下流人 abbr. (=computer-aided design)计算机辅助设计
arithmetic	n. 算术
representative	adj. 代表性的, 代议制的, 典型的 n. 代表, 众议员, 典型
typical	adj. 典型的, 有代表性的
sufficient	adj. 足够的, 充分的
blast	n. 爆破,冲击波,气流,一阵,汽笛声 vi. 爆破,突然发出声音 vt. 喷射,炸掉
clean	adj. 干净的, 正当的, 纯洁的, 完全的, 精准的, 空的 adv. 完全地 n. 清洁 vt. &vi. 打扫,清扫
caret	n. 脱字符号, ( 符号：^ 文章中插字使用)
socket	n. 插座,插口, 穴孔 vt. 装上或插入插座
stated	adj. 决定了的, 一定的, 定期的 v. 陈述, 说明 vbl. 陈述, 说明
protocol	n. 草案, 协议,礼仪 vt 拟定议定书
presence	n. 出席,在场者,举止
telephone	n.电话； 电话机； （电话机的）话筒； 受话器 vt.& vi.以电话传送（消息），给（某人）打电话； 用电话与（某人）交谈
social	adj. 社会的,群居的,社团的
equipment	n. 设备,装备
lending	n. 借贷, 借贷物 动词lend的现在分词形式
book	n. 书,本子 vt. 登记,预订 vi. 通过...预订
situation	n. 位置, 形势, 局面, 处境, 状况, 职位
desk	n. 书桌
please	int. 请 vt. 取悦,请,合心意 vi. 取悦,愿意
mixture	n. 混合, 混合物
representation	n. 表示法,表现,陈述，答辩
esoteric	adj. 秘传的，神秘的，难懂的
depth	n. 深度,强度,诚挚
final	adj. 最后的 决定了的 n. 决赛,期末考试
physically	adv. 身体上地
aid	n. 帮助,救护,辅助物 vt. &vi. 援助,帮助,救护 abbr.=Agency for International Development 国际开发署[美]
successive	adj. 接连的, 连续的, 接二连三的
succession	n. 连续, 继承权, 继位
unpack	vt. 打开取出, 卸下
chunk	n. 厚块（片）, 相当大的量，矮胖的人或物 vt. （高尔夫球）没击中 vi. 发出猛冲的声音
alignment	n. 队列，成直线；校准；结盟
typewriter	n. n. 打字机
big	adj. 大的,重要的 adv. 以郑重的方式,大数量 n. 杰出的组织和个人
tone	n. 音调,语气,品质,调子,色调 vt. 使更健壮,装腔作势地说, 定调, 调色 vi. 调和(颜色), 呈现悦目色调
sensitive	adj. 敏感的,灵敏的,易受伤害的,感光的,善解人意的 n. 敏感的人
reduction	n. 减少,缩小, (化学)还原反应, (数学)约分
indentation	n. 刻痕，印压, 缩进, （海岸线等）凹进处
terminology	n. 术语,术语学
ascending	adj. 上升的 动词ascend的现在分词
augment	vt. 增加,补充 vi.扩大 n. 增加,补充物
increment	n. 增加(增加物, 增量, 余差)
gain	n. 增益, 获得, 利润 vt. 得到, 增进, 获利 vi. 增加, 得到, (钟, 表等)走得快
stream	n. (人,车,气)流,水流,组 vt. 流出,飘动 vi. 流动,飘动,接踵而来
obsolete	adj. 已废弃的, 过时的
accommodate	vi. 使自己适应 vt. 使一致，和解；提供方便；容纳；顾及
motif	n. 主题, 意念, 动机
subject	n. 科目, 主题; 缘由 n. (君主国)国民; 实验对象 adj. 服从的, 易患的 vt. 使隶属, 使服从; 使遭遇
job	n. 工作,职责,任务 vt. 投机买卖,营私舞弊,不公正地判罚,分包任务 vi. 工作,假公济私,做分销商或批发商 adj. 与工作有关的
differentiate	vt. 识别, 使差异, 求导数, 区分, 区别对待 vi. 区别,变异
distinction	n. 区别; 卓越; 殊荣
distinguish	vt. 区别,辨认,特别关注 vi. 区别
locking	n. 锁定 动词lock的现在分词形式
progress	n. 进步, 发展, 前进 vi. 促进，进步, 进行
fundamental	adj. 基本的,根本的,重要的 n. 基本原理,基础
basis	n. 基础,根据,主要成分
underlying	adj. 在下面的, 基本的, 隐含的
sound	vt. 听（诊）；测量，测…深；使发声；试探；宣告 n. 声音，语音；噪音；海峡；吵闹；听力范围；[医] 探条 adj. 健全的，健康的；合理的；可靠的；有效彻底的 adv. 彻底地，充分地 vi. 听起来；发出声音；回响；测深
vital	adj. 至关重要的, 生死攸关的, 有活力的, 充满生机的
national	adj. 国家的,民族的 n. 国民
sale	n. 销售(量),削价出售
agree	vt. 同意,赞成,承认 vi. 同意,一致,符合
iterative	adj. 迭代的, 重复的
inclusive	adj. 包含...在内的, 包罗广泛的, 包括端点的 [计算机] 包括的
charm	n. 魔力, 魅力, 护身符, 小饰物 vt. 吸引, 使...迷醉, 对...施以魔法
hit	n. 打(击),冲撞,讽刺,成功.一次毒品的剂量,点击量 vt. 打(击),碰撞,偶然发现,要求,符合 vi. 打(击),袭击,达到
course	n. 课程, 讲座, 过程, 路线, 一道(菜)
numerical	adj. 数字的, 用数字表示的
digital	adj. 手指的,数字的,数码的,电子的
combo	套餐，结合物
cord	n. 绳索,束缚 vt. 用绳索绑
start	n.开始； 动身； 开动； 起点 vt.& vi.出发，启程 vt.起动； 提出（问题）； 开办； 使开始 vi.起始； 突然出现； 突然跳起； 突然涌出
directory	n. 目录,工商名录,指南 [计算机] 目录 adj. 给予指导的
operate	vi. 操作, 运转 vt. 起作用, 动手术
update	vt. &vi. 更新,补充最新资料 n. 更新
switch	n. 开关, 电门，闸，转换器, vt. &vi. 鞭打，转轨，交换，突然转变, 摆动，接通或切断…电流
organise	vt.组织,创办
permit	n. 许可证,执照 vt. &vi. 允许,许可
macro	adj. 巨大的，大范围的，总的 n. [计算机]宏
still	adj. 静止的, 不动的, 静寂的 adv. 仍然,更,静止地 conj. 然而,但是 vi. 变沉默 vt. 使冷静, 抓住, 使停止, 使放松 n. 沉默, 定格照, 酒厂
describe	vt. 描述, 画(尤指几何图形)
designate	adj. 指定的 vt. 指定,选派,标明
appropriate	adj. 适当的, 相称的 vt. 拨出(款项); 占用
alternate	adj. 交替的, 轮流的, 间隔的 vt. &vi. 交替, 轮流
explicit	adj. 明确的,详述的，明晰的,外在的
vertical	adj. 垂直的,顶点的,纵向的 n. 垂直物, 垂直的位置
horizontal	adj. 水平的,横的 n. 水平线,水平面
address	n. n.地址； 通信处； 演说； 称呼
elapse	v. 逝去, 过去
window	n. 窗户
alphabetical	adj. 按字母表顺序的
process	n.过程； 工序； 做事方法； 工艺流程 vt.加工； 处理； 审阅； 审核 vi.列队行进 adj.经过特殊加工（或处理）的
identical	adj. 相同的,同一的
rate	n. 比率, 等级, 价格 vt. 估价, 认为, 定等级; 责骂 vi. 受欢迎, 受推崇; 责骂
accidental	adj. 意外的,偶然的,附属的 n. 偶然,不重要的东西,变调的临时符号
sequential	adj. 连续的(序贯的)
indirect	adj. 间接的, 迂回的，次要的，不坦率的，欺骗的
reappear	vi. 再出现
vary	vt. 改变,使多样化 vi. 变化,违背
circumstance	n. 环境,(复数)境况,事件,详情
assign	v. 分配,指派 n.[计算机] DOS 命令将驱动器符重指向第二个驱动器符
finish	n. 完成,最后加工,结局,完美 vt. 结束,获...第几名 vi. 终结,完成
mix	n. 混合(物),融合 vt. &vi. 混合,掺入,合成,交往,联系 [计算机] 混合
open	n. 公开,户外,空旷 adj. 开着的,开放的,公开的 vt. 打开,公开,开放,开始 vi. 开, 通行,大叫
convert	v. 使转变, 使...改变信仰, 倒置 n. 皈依者, 改宗者
align	vt. 使成一行, 使一致, 使结盟, 调整, 排列 vi. 成一条线
allow	vi. (for)考虑到,使可能 vt. 给予,承认,允许, 断定
suppress	vt. 镇压,使...止住,禁止
E	n.字母E
exceed	vt. 超过, 胜过, 超出界限 vi. 领先
library	n. 图书馆, 藏书
dynamic	adj. 动态的, (有)动力的, (有)力的; 有活力的 n. 动力; 力学
recognition	n. 认出,承认, 感知，知识