access	n.入口，出口； 接近，进入； 增长； 爆发 vt.接近，进入； 使用，接近，获取
arm	n. 手臂, 港湾, 狭长地带, 扶手, 袖子, 枪 vt. 装备, 准备(炸弹) vi. 武装自己
time	n.时间； 时刻； 时代； 次 vt.为…安排时间； 测定…的时间； 调准（机械的）速度； 拨准（钟、表）的快慢 vi.合拍； 和谐； 打拍子 adj.定时的； 定期的； [美国英语]分期（付款）的
address	n. n.地址； 通信处； 演说； 称呼
alphanumeric	adj. 字母数字的
analog	n. (=analogue)类似(模拟量) adj. 类比的, 模拟的
computer	n. 计算机
analyst	n. 分析家
area	n. 地区, 区域, 面积, 方面
array	n. 数组,(陈)排列,大批,一系列 vt. 排列,布署,打扮
assembler	n. 装配工 n. [计]汇编程序
automation	n. 自动化
band	n. 带;箍,队,乐队 vt. &vi. 联合,结合
batch	n. 一次所烘的面包,一次所制之量,一组, 批, 分批 vi. 分批处理
binary	adj. 二进位的,二元的 n. 二进制,二元
code	n. 码,密码,法规,准则 vt. 把...编码,制成法典
digit	n. 数字,位数,指头
bit	n. 一点儿,少量 n. 钻头,马嚼子,辅币 n. 位,比特(二进位制信息单位) v. 控制
branch	n. 分支,树枝 vt &vi. 分支, 分岔
brush	n. 刷子,画笔,轻擦,小冲突, 灌木丛 vt. 用刷子清洗,画,拭去,打发 vi. 轻擦,拂拭
buffer	n. 缓冲,缓冲区 vt. 减轻,缓冲
storage	n. 储存体, 储藏, 仓库, 保管费
calculator	n. 计算器
call	v.呼唤，喊叫； 召唤，叫来，召集； 下令，命令； 打电话给 n.喊叫，大声喊； 电话联络； 必要，理由； 要求
instruction	n. 说明,须知,指令,教学
card	n. 卡片,纸牌,名片,打牌,节目单 vt. 附上或提供卡片,印卡,在卡片上列出,检查资格
punch	n. 打洞器,钻孔机,殴打 n. 酒、水、糖等制成的鸡尾酒 vt. 以拳重击,开洞,剪票,按(键)
reader	n. 读者，读物, 读本
cell	n. 细胞, 电池, 小组, 小房间, 单人牢房, (蜂房的)巢室, 手机
channel	n. 通道,频道,海峡,方法 vt. 引导,开导,形成河道,输送
character	n. 个性, 品质; 字符; 人物; 名誉; 地位
check	vt.检查，核对； 制止，抑制； 在…上打勾 vi.核实，查核； 中止； 打勾； [象棋]将一军 n.<美>支票； 制止，抑制； 检验，核对
circuit	n. 电路,一圈,巡回 vt. &vi. 巡回
to	prep. (表示方向)到,向；(表示间接关系)给；离,对于,为了 adv. （表示方向）去,（门）关上
clear	adj. 清楚的,明确的,澄清的,头脑清醒的 vt. 澄清,清除障碍, 使明亮, 明确 vi. 变清晰, 消失, 放晴 adv. 清楚地, 一直 n. 间隙, 空地, 开旷的地方
clock	n. 时钟, 计时器
coder	n. 编码器
command	n.命令，指挥； 司令部，指挥部； [计算机]指令； 控制力 vt.指挥，控制，命令； 命令； 应得，值得 vi.给出命令； 命令，指令 adj.指挥的，根据命令（或要求）而作的
compiler	n. 编辑者，[计算机]编译器, 编译程序
console	vt. 安慰,慰藉 n. 仪表盘,操控台,(游戏)平台
control	n. 克制,控制,管制,操作装置 vt. 控制,掌管,支配
unit	n. 单位, 单元
core	n.中心，核心，精髓； 果心，果核； [地质学]地核； [计] 磁心 vt.去（果）核，挖去…的果心； 提取岩芯（样品）
store	n. 商店,贮藏,仓库 vt. 储存,贮藏,供给,保存 adj. 储备的 (在计算机里)存贮；记忆
counter	n. 计算器,计算者,柜台 [计算机] 计数器 adj. 相反的 adv. 与…相反地 vt. 反对,反击 vi. 反对,反击
cybernetics	n. 控制论
cycle	n. 循环,周期,长期,圈,套曲,自行车, vt. 环行,骑自行车 vi. 使环行
data	n. (datum的复数)资料,数据
decision	n. 决定,决心
digital	adj. 手指的,数字的,数码的,电子的
disc	n. 圆盘，[电子] 唱片（等于disk） vt. 灌唱片
disk	n. 圆盘,唱片,花盘,盘形物,光盘 vt. 用圆盘耙耙地 [计算机] 磁盘
display	n. 显示,陈列,炫耀 vt. 显示,表现,夸示
drum	n. 鼓, 鼓声, 鼓状物, 冰丘 vi. 击鼓, 作鼓声, 引起兴趣 vt. 召集入伍, 逐出, (经过努力)推动..., 连续击打
edit	vt. 编辑,编校,修订 n. 编辑工作
electronics	n. 电子学，电子器件
emitter	n.发射器
encode	vt. 编码, 译码
erase	v. 抹去,擦掉 [计算机] 擦除
feed	vt.喂养； 满足（欲望等）； 向…提供； 供…作食物 vi.吃，以…为食； 流入，注入，进入（如油流入机器）； [电子学]馈入 n.饲料（尤指粗饲料），施肥； 喂送； 草料
feedback	n. 反馈,成果
field	n. 领域；牧场；旷野；战场；运动场 vi. 担任场外队员 adj. 扫描场；田赛的；野生的 vt. 把暴晒于场上；使上场；(通常成功地)回答，处理(问题)
file	n. 档案,公文箱,锉刀,[计算机] 文件 vt. 列队行进,归档,申请
floppy	adj. 叭塌叭塌响的,懒散的,邋遢的
drive	v. 开车, 驱使, 驾进力 n. 驾车, 快车道, 推进力, 驱使, 路, 街
flow	vi.流； 垂； 流出； （谈话、文体等）流畅 n.流动； 滔滔不绝； 涨潮； 连贯 vt.使泛滥； 淹没； 排出
chart	n. 图表 vt. 制成图表
frame	n. 框,结构,骨架 v. 构成，把...框起来，陷害 adj. 木结构的
hardware	n. 五金器具 n. (计算机) 硬件
identifier	n. 标识符
index	n.索引； <数>指数； 指示； 标志 vt.给…编索引； 把…编入索引； [经济学]按生活指数调整（工资、价格等） vi.[机械学]转位
information	n. 信息, 情报, 新闻, 资料, 询问
input	n. 输入
inquiry	n. 打听, 询问, 调查, 查问 =enquiry(英)
integrated	adj. 整合的,综合的 vt.&vi. 使整合(integrate的过去式及过去分词)
interpret	v. 解释, 演出, 翻译 [计算机] 解释
item	n. 项目,条款， 一件商品（或物品） adv. 也
jump	n. 跳跃,跳动,上涨 vt. &vi. 跳越,突升,惊跳
key	adj. 主要的,关键的 n. 钥匙,关键,答案,按键,音调 vt. 上锁,调节,提供解答,键入 vi. 使用钥匙
keyboard	n. 键盘 vt. 用键盘输入(信息)
latency	n. 潜伏, 潜在
library	n. 图书馆, 藏书
linkage	n. 连合, 连锁, 结合
location	n. 地点,位置
logger	n. 伐木工, 记录器, 注册器
loop	n. 环,圈,弯曲部份,回路 vt. 使...成环,以圈结,以环连结 vi. 形成环,环形地行动
machine	n.机器，机械； 机械般的人； 核心 vt.用机器制造，用机器加工 vi.被机器切削
magnetic	adj. 有磁性的,有吸引力的,催眠术的
matrix	n. 母体,子宫 细胞 脉石,字母 n.矩阵
memory	n. 记忆,内存,回忆
message	n. 消息,信息,要点 vt. &vi. 传递信息, 通讯
microcomputer	n. 微电脑 [计算机] 微机计算机
module	[计算机] 模块 n. 组件
monitor	n. 监督器, 班长, 监听员, [计算机]显示器, 监视器 v. 监视, 监听, 监督
nanosecond	n. 毫微秒，极短的时间
network	n. 网络,系统,广播网 vt. 用网覆盖,联网 vi. 加入网络
numeric	adj. 数字的，数值的 n. 数，数字
octet	n. [音] 八重唱, 八重奏 n. 八位位组
operator	n. 操作员,管理者,技工,报务员
optical	adj. 眼睛的, 视觉的, 光学的
output	n. 产量,输出,输出功率,输出端 vt. 输出(信息等)
overflow	n. 溢值,超值,泛滥 v. 泛滥,溢出,充溢 [计算机] 溢出
panel	n.镶板； 面； （门、墙等上面的）嵌板； 控制板 vt.选定（陪审团）； 把…分格； 在…上置鞍垫； 把…镶入框架内
parameter	n. 参数,参量,决定因素
perforator	n.穿孔器,穿孔员
peripheral	adj. 不重要的,外围的 n. 外围设备
personal	adj. 私人的,个人的 n. (报刊的)私人专栏
printer	n. 打印机，印刷工
printout	n. (电脑)打印输出
process	n.过程； 工序； 做事方法； 工艺流程 vt.加工； 处理； 审阅； 审核 vi.列队行进 adj.经过特殊加工（或处理）的
program	n. 节目(单),程序,计划 vt. 规划,拟定计划,制作节目
programmer	n.程序员, 程序规划员 ,节目编排者 =programer（英）
programming	n. 程序设计, 编程 动词program的现在分词
pulse	n. 脉冲,脉波,脉搏 vt. &vi. 跳动,脉跳
random	n. 随意,任意 adj. 任意的,随便的,胡乱的 adv. 随机地
reading	adj. 阅读的 n. 阅读
real	adj. 实际的,现实的,真的,真实的 adv. 非常 n. 真实的事, 真实
redundancy	n. 冗余,备份,多余信息
routine	n. 例行公事, 常规，无聊 adj. 常规的, 例行的，乏味的
selector	n. 挑选者，选择器
sentinel	n. 哨兵(标记,传送) vt 放哨(守卫)
sequence	n. 序列, 一系列, 顺序, 一组镜头 vt. 安排顺序
sequential	adj. 连续的(序贯的)
serial	n. 序列，串列 adj. 连续的，一连串的
shift	n. 交换,变化,移动,接班者 vt. 更替,移转,变声 vi. 改变,定责,更衣
signal	n. 信号,导火线,动机 vt. 发信号,标志 vi. 发信号 adj. 显著的
simulation	n. 模拟,仿真,赝品
simulator	模拟程序
software	n. 软件
sort	n. 种类,样子,态度 v. 分类,整理,排序 n.[计算机] DOS命令 : 在字符型文件中进行数据排序, 或者将DOS命令的输出进行排序
sorter	n.从事分类的人,把东西分类拣选的人
switch	n. 开关, 电门，闸，转换器, vt. &vi. 鞭打，转轨，交换，突然转变, 摆动，接通或切断…电流
symbol	n. 符号, 标志, 象征
symbolic	n. 代号 adj. 象征的, 符号的
system	n. 系统,体系,制度,体制
tabulator	n. 制表者, 制表机, 跳格键
teleprinter	n. 电传打印机
terminal	n. n. 终端机,终点,末端 adj. 终点的,晚期的,致死的
timer	n. 计时员，记时器, 跑表
timing	n. 时间的掌握(安排, 配合)
track	n. 小路, 跑道, 轨道, 踪迹; 惯例, 常规 v. 跟踪, 追踪
transducer	n. 转换器, 传感器
translator	n. 翻译者
Winchester	n. 温彻斯特(英格兰南部城市)
working	adj. 工人的, 劳动的
multimedia	adj. 多媒体的 n. 多媒体
pentium	Intel公司生产的CPU芯片,中文译名为"奔腾"
environmental	adj. 环境的
kilo	pref. 表示“千” abbr. 千克，公斤(=kilogram/kilogramme)
mega	兆, 百万
giga	pref. 千兆
byte	n. 字节, 8位元组
link	n. 环节,联系, (链的)环, 圈 vt. &vi. 连接,联系