file	n. 档案,公文箱,锉刀,[计算机] 文件 vt. 列队行进,归档,申请
command	n.命令，指挥； 司令部，指挥部； [计算机]指令； 控制力 vt.指挥，控制，命令； 命令； 应得，值得 vi.给出命令； 命令，指令 adj.指挥的，根据命令（或要求）而作的
use	n. 运用,用法,使用权,适用 vt. 使用,利用,对待 vi. 吸毒
program	n. 节目(单),程序,计划 vt. 规划,拟定计划,制作节目
line	n. 行,线,航线,场界,皱纹,家族 vt. &vi. 用做衬里,排成一行,顺...排列 vi. 排成一行,顺...排列,划线于
if	conj. 如果，是否，即使 n. 条件,设想
display	n. 显示,陈列,炫耀 vt. 显示,表现,夸示
set	vt.放置，安置； 使处于某种状况； 设置； 摆放餐具 vi.落山； 出发； 凝结 n.一套，一副； 集合； 布景； 电视机 adj.固定的； 位于…的； 顽固的； 安排好的
key	adj. 主要的,关键的 n. 钥匙,关键,答案,按键,音调 vt. 上锁,调节,提供解答,键入 vi. 使用钥匙
list	n.清单，目录； 倾斜； 布边，布头； 狭条 vt.列出，列入； 把…编列成表； 记入名单内 vi.列于表上
by	prep. 被, 经由, 在...之前, 根据 adv. 靠近, 经过, 放在一旁地 adj. 在旁边的, 附带的 n. 次要的事件
press	vt.压，按； 逼迫； 紧抱 vi.压； 逼迫； 重压 n.强迫征兵； 新闻报道，出版物； 压榨； 印刷机（厂）
with	prep. 和...一起,用, 随着, 包括
format	n. 设计,版式 n.[计算机]格式,DOS命令 : 格式化(磁盘),用于空盘或使用过的磁盘建立新空盘来存储数据 v. vt.使格式化,设计,安排
change	n. 变化, 零钱 v. 改变
cursor	光标
directory	n. 目录,工商名录,指南 [计算机] 目录 adj. 给予指导的
from	prep. 从,从...起
menu	n. 菜单
option	n.选择（的自由）； 选项； 选择权； 选择能力 vt.得到或获准进行选择； 调动球员
character	n. 个性, 品质; 字符; 人物; 名誉; 地位
current	n. (水、气、电)流, 趋势 adj. 流通的, 现在的, 最近的
type	n.类型； 铅字； （印刷或打印的）文字； 于…类型的 vt.& vi.打字 vt.[医学]测定（血型）； 按类型把…归类； 成为…的典型； [印刷]浇铸（铅字等）
screen	n.屏幕； 银幕； 屏风 vt.筛（煤、矿石等）； 拍摄； 放映（电影）； 庇护
specify	vt. 明确说明,叙述,指定,详细说明
move	vt.& vi.移动，搬动 vi.搬家； 行动； 进展； （机器等）开动 vt.提议； 使感动； 摇动； 变化 n.改变； 迁移
disk	n. 圆盘,唱片,花盘,盘形物,光盘 vt. 用圆盘耙耙地 [计算机] 磁盘
text	n. 本文, 文件, 正文, 课文 vt. &vi. 发短信
drive	v. 开车, 驱使, 驾进力 n. 驾车, 快车道, 推进力, 驱使, 路, 街
see	vt. 看见,经历,明白,确保,视为,拜访,陪同 vi. 注意,想象,了解,调查 n. 主教教区,主角权限
name	n. 名字, 名称, 姓名 vt. 命名, 称呼, 任命 adj. 有名的, 著名的
record	n. 记录,纪录,唱片 vt. 记录,(将声音等)录下，表明 adj. 关于
box	n. 盒子,箱,专席,亭子,窘境 vt. 装...入盒中,限制住,调和,改变形状,用拳击... vi.参与拳击
database	n. 数据库
help	n. 帮助,援助 vt. &vi. 帮助,改善
memory	n. 记忆,内存,回忆
all	adj. 所有的,全部的 adv. 全部,非常,全然,所有 pron. 全部,所有 n. 全部
on	prep. 在...之上,由…支撑着,在（某一天）,使用, 根据 [计算机] 开 adv.穿着,向前（移动),（表示持续性） adj. 表示已连接、处于工作状态或使用中,表示发生,值班 abbr.=Ontario
copy	n.复制品； 一份； （报刊等的）稿件； 准备排印的书面材料 vt.& vi.复制； 抄写； 容许复制的 vt.模仿； 仿造…的样式或图案； 抄写； 复制
shell	n. 贝壳,壳,外形 vt. &vi. 去壳,脱落,炮击,拾贝壳 n.[计算机] DOS命令 : 安装备用的COMMAND.COM文件, 并改变环境尺寸
delete	vt. 删除
enter	vi. 进入,参加,开始,上台,进入角色 vt. 进入,报名,开始,加入,报价,提出 [计算机] 送入
margin	n. 差额,利润,页边空白,边缘 vt. 使围绕于,加边缘
mark	n. 污迹, 标记, 分数, 烙印, 纪录 vt. 做标记于, 留意, 打分数, 留下污痕, 使...明显 vi. 做标志, 记分, 留下印记
also	adv. 也, 同样地, 而且
do	aux. 助动词(无词意) v. 干,做
information	n. 信息, 情报, 新闻, 资料, 询问
choose	vt. &vi. 选择
select	adj. 精选的 n. 被挑选出来的人或物 v. 选择 vi. 选择,挑选,选拔 vt. 选择,挑选
group	n. 团体,组,团 vt. &vi. 聚合,成群 [计算机] 成组
first	adv. 首先,第一,优先 adj. 第一的, 最早的, 一流的 n. (序数词)第一, 第一个人或事物, (大学学位的)最优等, (汽车, 自行车等的)最低挡
field	n. 领域；牧场；旷野；战场；运动场 vi. 担任场外队员 adj. 扫描场；田赛的；野生的 vt. 把暴晒于场上；使上场；(通常成功地)回答，处理(问题)
procedure	n. 程序, 手续, 步骤; 常规的做法
print	n. 版,印刷物,印迹 vt. &vi. 印刷,出版,打印 adj. 印刷的
return	n. 返回,归还,报答,报告 vt. &vi. 返回,归还,回来 adj. 返回的
number	n. 号码,数字 v. 编号,加号码,总计 vi. 总计 vt. 编号
selected	adj. 选定的 动词select的过去式和过去分词
want	n. 缺乏, 贫困, 欲望, 需要, 不足 vi. 要, 希望, 必须 vt. 缺少, 渴望, 喜欢, 应该
window	n. 窗户
message	n. 消息,信息,要点 vt. &vi. 传递信息, 通讯
dialog	n. 对话, 对白 （美）=dialogue
example	n. 榜样,例子 vt. 把...作为例子
create	vt. 创造, 造成
insert	n. 插入物 vt. &vi. 插入
related	adj. 有关系的,有关联的 v. 讲,有关系 vbl. 讲,有关系
item	n. 项目,条款， 一件商品（或物品） adv. 也
edit	vt. 编辑,编校,修订 n. 编辑工作
marked	adj. 有记号的,显著的,醒目的 v. 作记号,打分数,表示 vbl. 作记号,打分数,表示
area	n. 地区, 区域, 面积, 方面
parameter	n. 参数,参量,决定因素
then	adv. 那么, 当时，然后，于是 adj. 当时的
variable	adj. 可变的,易变的 n. 变量, 易变的东西
tab	n.(tabulate)制表, 标签, 垂饰, 拉环,账单 vt. 用标签或垂饰安装
up	adv. 向上,增加,用尽,完全,储存,靠近 adj. 向上的,直立的,完成的,高兴的,在进行的 prep. 向上,迎着 n. 上司,上坡,繁荣,上面 vt. 升起,增加 vi. 上升
string	n. 线,一串,字串 vt. 串起,成串,收紧, 悬挂；系；扎 vi. 给…装弦 adj. 线的
each	adj. 每个, 每, 每一 adv. 每个 int. 每个, 个人, 个自
active	adj. 积极的；活跃的；主动的；有效的；现役的 n. 主动语态；积极分子
topic	n. 题目, 话题, 主题
start	n.开始； 动身； 开动； 起点 vt.& vi.出发，启程 vt.起动； 提出（问题）； 开办； 使开始 vi.起始； 突然出现； 突然跳起； 突然涌出
mode	n. 方式,样式,模式,风格,时兴 [音乐] 调式
selection	n. 选择,挑选,挑选出来的人或事
function	n. 功能, 函数, 重大聚会 vi. 运行, 起作用
word	n. 词, 单词, 消息, 诺言 vt. 用词语表达
make	vt.做，制造； 生产，制定； 使成为； 使产生 vi.开始； 尝试； 行进； 增大 n.制造； 生产量； 性格； 形状，样式
right	adj. 正确的,正直的,合适的,垂直的,右面的，正常的,正面的 n. 权利,右，正义，实况 adv. 正好,恰当,径直地,正确地,立即,非常,向右边 vt. 纠正,扶直,公正对待,伸冤 vi. 复正
value	n. 价值, 重要性, 价格, (pl)价值观 vt. 评价, 估价, 重视
button	n. 钮扣,徽章,像纽扣的东西,未成熟的蘑菇,按钮 vt. 用纽扣装饰,钉纽扣,闭嘴 vi. 扣上
index	n.索引； <数>指数； 指示； 标志 vt.给…编索引； 把…编入索引； [经济学]按生活指数调整（工资、价格等） vi.[机械学]转位
without	adv.在外部； 户外； 缺少； 没有或不显示某事物 prep.没有，缺乏； 在外面 conj.除非，如果不
appear	vi. 出现,显得,出版,抵达
left	adj.左边的，左侧的； 左派的 n.左，左面； [军]左翼； 左派，激进分子 adv.向左； 在左边 v.离开( leave的过去式和过去分词)
save	vt.节省； 保存； 储蓄； 解救 vi.节省； 挽救； 救球 prep.&conj.除…之外 n.救援，救援
next	adj.紧接在后的； 次于的； 贴近的； 紧邻的 adv.接下去； 然后； 居后地； 依次的 n.下一位； 下一个 prep.靠近； 居于…之后； 在…的隔壁
off	adj. 远的,休假的,空闲的,落后懈怠的 adv. 离开,出发,距离隔断,分割,不继续运行,下台 prep. 离开,脱落,下班 vi. 离开, 走开
following	n. 下列各项,部下,党羽 adj. 下列的,其次的 prep. 在（某事）以后
control	n. 克制,控制,管制,操作装置 vt. 控制,掌管,支配
only	adj. 最好的,唯一的,出众的 adv. 仅仅,只有,专门地,唯一地,刚才 conj. 除非, 但是, 然而, 毕竟
user	n. 用户, 使用者
end	n. 结束,终点,目标,末端 vt.& vi. 结束,终结 adj. 最终的
system	n. 系统,体系,制度,体制
contain	vt. 包含,容纳,克制,抑制 vi. 自制
time	n.时间； 时刻； 时代； 次 vt.为…安排时间； 测定…的时间； 调准（机械的）速度； 拨准（钟、表）的快慢 vi.合拍； 和谐； 打拍子 adj.定时的； 定期的； [美国英语]分期（付款）的
letter	n.信； 证书，许可证； 字母，文字； 字面意义 vt.用字母标明； 写字母于； 加标题 vi.写印刷体字母
data	n. (datum的复数)资料,数据
setting	n.镶嵌； 环境； 装置； （某事、戏剧、小说等的）背景 v.放( set的现在分词)； 安插； 树立； 安排
desire	n. 愿望, 欲望, 情欲 v. 向往, 要求, 请求 vt. 渴望
position	n. 位置, 职位; 状态, 立场 vt. 安置, 决定...的位置
down	adj. 向下的,降低的,情绪低落,停止运行 adv. 向下的,下跌,在南方 n. 绒毛,汗毛,轻视 prep. 沿着...而下
task	n. 工作,任务 vt. 交给某人（任务)
view	n. 视野,风景,见解,方法,检查 vt. 把...视为,看,考虑
switch	n. 开关, 电门，闸，转换器, vt. &vi. 鞭打，转轨，交换，突然转变, 摆动，接通或切断…电流
include	v. 包括,包含,连...在内 [计算机] 包括
get	vt. 使得；获得；受到；变成 vi. 成为；变得；到达
default	n. 假设值,默认(值),不履行责任,缺席 v. 默认,不履行义务,缺席,拖欠 [计算机] 缺省
structure	n. 结构,构造,建筑物 v. 构成,建立,建造
into	prep. 到...里
path	n.小路，路； 路线，路程； 〈比喻〉（人生的）道路； （思想，行为，生活的）途径
blank	adj. 空白的, 茫然的, 全部的, 面无表情的, 未完工的 n. 空白(处), 空隙, 空虚, (有弹药而无弹头的)空弹 vi. 消失, 走神 vt. 使模糊不清, 删除, 封闭, (比赛时连续得分)使对手得零分
open	n. 公开,户外,空旷 adj. 开着的,开放的,公开的 vt. 打开,公开,开放,开始 vi. 开, 通行,大叫
add	vt. &vi. 增加
enable	vt. 使...能够,使可行 [计算机] 使能
operation	n. 手术, 行动，活动, 操作
erase	v. 抹去,擦掉 [计算机] 擦除
filename	文件名
search	n. 搜寻, 探究 v. 搜寻, 探求, 调查
another	adj. 另一,再一 pron.&amp;prep. 另一个
last	adj. 最后的,末尾的,最近的,晚了，迟到了 adv. 最后,最新 n. 最后来的人（或发生的事） vi. &vt. 持续
column	n.纵队，列； 圆柱； 专栏
after	adj. 以后的 adv. 以后, 后来 conj. 在...以后 prep. 在...之后
prompt	adj. 迅速的, 敏捷的, 立刻的 vt. 激起, 促进, 推动; 提示 vi. 提示 n. 提示; 提示的内容 n. [商]付款期限
two	num. 二，两个
execute	vt. 执行,处决，实行,完成 [计算机] 执行