about	adj. 准备 adv. 大约 prep. 关于
escape	n. 逃亡,避难设备 vt. &vi. 逃脱,避开 adj. 逃避的
error	n. 错误, 过失
currently	adv. 现在，现时，目前，当前
extension	n. 延长,扩充,范围,分机号码
same	adj. 同样的 adv. 同样地 pron. 同样的人或事
status	n. 地位, 身份, 情形, 状况
run	n. 奔跑,路程,趋向 vt. 跑,放牧,经营,走私,使运转,浇铸,使遭受 vi. 跑,竞赛,行驶,运转,遭遇,持续,熔化,褪色,流,蔓延,传播 adj. 熔化的,浇铸的,洄游的
argument	n. 辩论,争论,论点(据),理由
statement	n. 声明, 陈述
shift	n. 交换,变化,移动,接班者 vt. 更替,移转,变声 vi. 改变,定责,更衣
store	n. 商店,贮藏,仓库 vt. 储存,贮藏,供给,保存 adj. 储备的 (在计算机里)存贮；记忆
scroll	n. 卷轴,目录 vt.& vi. 卷动
replace	vt. 取代,更换
macro	adj. 巨大的，大范围的，总的 n. [计算机]宏
page	n. 页 v. (给...)当听差 vt. (通过扩音器、传呼机等)呼叫
quit	v. 离开,辞职,停止
define	vt. 定义, 解释
reference	n. 参考, 出处, 参照 n. 推荐人, 推荐函 vt. 提供参考
other	adj. 别的,其他的 pron. 另一个人(或事) n. 其他人(或事)
while	conj. 当...的时候,然而 n. &adj. 一会儿 vt. 消磨
pressing	adj. 紧迫的,紧急的,切实的 vbl. 压迫
restore	vt. 恢复,归还,翻新
top	n. 顶端, 极点, 盖子, (女式)上衣, 最高地位, 陀螺 adj. 最高的, 顶上的, 最一流的 vt. 高耸, 加以顶盖, 超越, 上升到顶端 vi. 得出结论, 到达顶峰
how	adv. 如何,怎样,多么,多少 conj. 如何,怎样,以...方式 n. 方式
color	n. 颜色,气色,风格 vt. 把...涂颜色,粉饰 vi. 脸红
allow	vi. (for)考虑到,使可能 vt. 给予,承认,允许, 断定
block	n.块； 街区； <英>大楼，大厦； 障碍物，阻碍 vt.阻止； 阻塞； 限制
decimal	adj. 十进位的,小数的 n. 小数
main	adj. 主要的 n. 主要部分,干线,（水、煤气、电等的）供应系统,体力
definition	n. 定义, 阐释，清晰度
between	adv. 在中间 prep. 在...之间
optional	adj. 可以任选的,非强制的
date	n. 日期,约会,枣椰子 vt. 约会,定日期 vi. 追溯到 n.[计算机] DOS命令 : 显示或设置系统日期
remove	n. 间距, 移动 vt. 除去,开除, 移动, 取下, 拿走 vi. 迁徙,离开,搬迁
arrow	n. 箭，箭头 vi. 快且笔直的前进有如穿梭的箭
label	n.标签； 称标记，符号； [建] 门或窗户上面的线脚 vt.贴标签于； 把…称为； 把…列为； [化]用放射性元素使（元素或原子等）示踪
within	adv. 在内 n. 里面 prep. 在...里面 adj. 在里面的
issue	n. 问题；流出；期号；发行物 vt. 发行，发布；发给；放出，排出 vi. 发行；流出；造成…结果；传下
different	adj. 不同的,与众不同的
available	adj. 可用的,可得到的,有用的，有效的
returned	adj.被送回的,归来的
associate	vt.（使）发生联系； （使）联合； 结交； 联想 vi.联盟； 陪伴同事 n.合伙人； 伴侣，同志； 非正式会员 adj.联合的； 合伙的； 非正式的； （性质上）有密切联系的
attribute	n. 属性, 特征; 标志, 象征 vt. 归于, 属于
DOS	n. [计] 磁盘操作系统（=Disk Operating System）
before	prep.在…之前； 先于，优于； 当着…的面； 与其… conj.在…之前； 在…以前； 比…早些； 与其… adv.先前，从前； 在前，在前方
order	n.命令； 秩序； 规则，制度； 次序 vt.命令； 订购； 整理 vi.下订单
modify	vt. 修改,调正,缓和 vi. 修改
array	n. 数组,(陈)排列,大批,一系列 vt. 排列,布署,打扮
mouse	n. 老鼠,鼠标，胆小如鼠的人，乌青色的肿块 vi. 捕鼠，蹑手蹑脚行动 vt. 仔细寻找
note	n. 笔记, 注解, 备忘录, 音符, 音调, 票据, 便条, 纸币 vt. 记录, 注解, 注意
locate	vt. 找出,设于,位于,建立 vi. 建立
video	adj. 录像的 n. 录像(机) vt. 制作...的录像
printer	n. 打印机，印刷工
bar	n. 条,棒,横木,酒吧 vt. 禁止,阻挠
bottom	n. 底部;臀部;船身;水底;服装下面的部分;低洼地;底色;尽头 adj. 底部的 vt. 给...装底,建立基础,到达底部 vi. 到达底部,垫底，降到最低点
carriage	n. 四轮马车,车厢
content	n. 内容, 目录, 含量 adj. 满足的, 满意的 vt. 使...满足, 使...安心
either	pron. 任一的 conj. 或, 也 adj. 任一, 两方的 adv. 也
OK	adj. 好, 不错, 可以 adv. 好, 不错, 可以
space	n. 位置, 空间, 距离, 太空, 空地, 持续的一段时间 vt. &vi. 均匀隔开, 分隔
editor	n. 编辑, 编者
exist	v. 存在
scope	n. 能力，范围，眼界，机会，余地 vt. 仔细研究
paragraph	n. 段落 vt. 将...分段,写短评 vi. 写短评
multi	n. 多种；多数
clear	adj. 清楚的,明确的,澄清的,头脑清醒的 vt. 澄清,清除障碍, 使明亮, 明确 vi. 变清晰, 消失, 放晴 adv. 清楚地, 一直 n. 间隙, 空地, 开旷的地方
exit	n. 出口,退场,离去 vi. 退出,死亡 vt. 离开
report	n. 传闻,报告,成绩单,爆炸声 vt. 报告,报导,记录 vi. 叙述,报告
execution	n. 实行,完成,执行
backup	n. 后备,后备
version	n. 版本, 说法，翻译
find	vt. &vi. 发现,感觉到,认为 n. 发现物
pointer	n. 指针，教鞭，（能指出猎物位置的）猎犬，暗示 Pointer: 指极星
subset	n. 子集
keyboard	n. 键盘 vt. 用键盘输入(信息)
full	adj.满的，装满的； 完全的，完整的； 丰富的； 详尽的 adv.极其，十分； 充分地，完全地； 整整； 直接地 n.充分，完全； 全部； 完整； 极盛时 v.把衣服缝得宽大； 把裙子缝出皱褶； [印]蒸洗，漂洗
check	vt.检查，核对； 制止，抑制； 在…上打勾 vi.核实，查核； 中止； 打勾； [象棋]将一军 n.<美>支票； 制止，抑制； 检验，核对
should	verb auxiliary. 应该,竟然,可能
single	adj. 单身的,单纯的,单一的 n. 单程票,单曲,单人房,单身者 vt. 单独挑出 vi. (棒球)作一垒打
provide	vi. 供给, 提供 vt. 提供; 规定; 准备
title	n. 头衔,名称,标题,所有权,资格,冠军 vt. 赋予称号,加标题于 adj. 标题的
expression	n. 表达,表示,表现,表情,措辞,词句
through	adv. 穿越, 完全 prep. 经过, 穿过, 凭借 adj. 完成的, 完结的; 贯穿的, 直通的
toggle	n. 乒乓开关，触发器，套索钉，棒形纽扣 vt. 系纽扣，提供索钉 vi. 开开关
code	n. 码,密码,法规,准则 vt. 把...编码,制成法典
such	adj. 如此的,这样的 pron. 这样的 adv. 如此地
beginning	n. 开始,开端，起源，早期 adj. 刚开始的 动词begin的现在分词
guide	vt.引路； 指导； 操纵； 影响 n.指导者； 向导； 导游； 有指导意义的事物
tree	n. 树
environment	n. 环境,外界
but	adv. 仅仅,只 conj. 但是 prep. 除...以外 pron. 只有
device	n. 装置, 设计, 策略, 设备
highlight	n. 加亮区,精彩部分, 最重要的细节或事件, 闪光点 vt. 加亮,强调, 使...显得重要, 照亮 [计算机] 醒目
call	v.呼唤，喊叫； 召唤，叫来，召集； 下令，命令； 打电话给 n.喊叫，大声喊； 电话联络； 必要，理由； 要求
continue	vt. &vi. 继续, 连续, 维持
indicate	v.指明, 表明, 显示, 象征, 指示
until	prep. 直到...为止 conj. 直到...时才...
begin	vt.& vi.开始； 着手； 创始； 创办 vi.（从…）开始； 起始； 起初是； 开始讲话
place	n. 地方,职位,获奖的名次 vt. 放置,任命,安排 vi. 获得名次
rename	v. 重新命名, 改名 n. [计算机]DOS命令
swap	n. 交换 vt. &vi. 交换,用...作交易
work	n. 工作,作用,成果,作品,善行,工艺,奏效,建筑工程,工厂,(机械)活动部件 adj. 工作的 vi. 创造, 实现, 有工作, 起作用, 操作, 正常运转, 成功, 产生影响, 逐渐进行, 处理 vt. 造成, 产生, 使运转, 锻造, 奋力达到, 利用
remain	v. 保持, 依然, 剩余, 留下, 逗留 n. 遗迹, 剩余物, 残骸
close	n. 完结, 结论 adj. 靠近的,亲近的，几乎，密切的, 势均力敌的 vt. 关,结束,靠近 vi. 关，停业, 搏斗 adv. 紧挨着, 紧紧地
combination	n. 结合,联合，联合体
profile	n.侧面，半面； 外形，轮廓； [航]翼型； 人物简介 vt.描…的轮廓； 给…画侧面图； 为（某人）写传略； [机]铣出…的轮廓
unless	conj. 除非 prep. 除...外
except	vt. 除,除外 prep.&conj. 除了...之外,若不是,除非
turn	vt.& vi.使转动； 旋转； 使改变方向； 使不适 vt.使变酸； 使变换； 使变为 n.翻转； （路线或方向的）改变； 机会
back	adj. 后面的，偏远的, 过时的, 积欠的, 向后的 adv. 向后地 n. 后背, 背脊，后面, 靠背 vt. 后退，支持 vi. 后退
sure	adj. 确信, 必然的, 必定的 adv. 当然, 确实地, 无疑地
section	n. 零件,部分,章节,区域,部门,路段,断面 vt. 划分,切开 vi. 划分
follow	vt. 跟随,沿行,遵循,听得懂 vi. 跟着做,之后是 n. 跟随
split	n. 劈开, 裂片, 裂口 adj. 分散的 v. 分离, 分开, 劈开
need	n. 需要,必须,缺乏 v. 需要,必需 conj. 需要
access	n.入口，出口； 接近，进入； 增长； 爆发 vt.接近，进入； 使用，接近，获取
additional	adj. 附加的, 另外的
cancel	n. 取消,撤消 vt. 取消,删去, 约分 vi. 抵消
document	n. 文件,公文 vt. 记载,用文件等证明 [计算机] 文档
case	n. 情况,实情,箱,案例 vt. 装箱,踩点
numeric	adj. 数字的，数值的 n. 数，数字
go	vi. 去, 走, 变得, 进行, 放, 通往, 消失 vt. 走过, 称重 [计算机] 执行
load	n. 负荷, 重担, 装载量 v. 装载, 装填, 担负, 给(枪)装子弹 [计算机] 装入
try	n. 尝试,试验 vt. 审理,尝试,试验 vi. 尝试
size	n. 尺寸, 大小 vt. 按大小排列(或分类) adj. 一定大小的 vt. 用...填充(某物)
entire	adj. 全部的,完整的，同性质的，纯正的，全面的
leave	离开, 告假, 遗留, 听任
history	n. 历史
second	n. vt. 支持 n. 第二,秒 adj. 第二的,次等的,另一个的
reflow	vi. 回流
output	n. 产量,输出,输出功率,输出端 vt. 输出(信息等)
out	vt. adj. 外面的,向外的,落伍的,不做考虑的 adv. 向外,离岸,外出,出局,出去,用尽,完成,出现,结束 vt. 释放出,揭露 vi. 揭发 prep. 向外,通过 n. 外面,在野者,下台者,出局的一击
both	adj.二者，两者都 pron.二者 adv.二者，二者都 conj.不仅…而且…，…和…都
install	v. 安装,安置,使...就职 n.[计算机] 安装,DOS命令 : 装入结束且驻留软件
source	n. 来源
way	n. 方法,道路,方向,作风,(某)方面,程度,状态 adv. 非常,很多,很远 adj. 与路线的中间点相关的,路线的中间点
assign	v. 分配,指派 n.[计算机] DOS 命令将驱动器符重指向第二个驱动器符
support	n. 支持, 援助, 供养 vt. 支援, 帮助, 支持
specific	adj. 特殊的, 明确的, 具有特效的 n. 特效药, 特性, 详情
join	v. 参加, 结合, 联合, 加入
expand	vt. 增加,详述,扩展,使...膨胀 vi. 扩展,增加,详述
like	adj. 相似的,同样的 vt. &vi. 喜欢,愿意,想 prep. 像,如同 n. 爱好,类似的人（或物） adv. 大概,和…一样 conj. 如同
Diskette	n. [计]软盘
skip	n. 跳跃,跳读 vt. &vi. 跳越,蹦跳,略过,跳过
application	n.适用，应用，运用； 申请，请求，申请表格； 勤勉，用功； 敷用，敷用药
confirmation	n. 确认, 证实, 基督教的坚信礼
whether	conj.&amp;adv. 是否
hold	vt.拿住，握住； 保留，保存； 扣留，拘押； 容纳 vi.拿住，握住； 同意，赞成； 保持不变； 有效 n.握住； 保留； 控制
click	n. 点击,滴答声,拍答声 vt. 点击,作滴答声,使...作拍答声 vi. 击打,完全符合,成功,以点击的方式选择
write	v. 写
byte	n. 字节, 8位元组
abbreviate	vt. 缩写，缩短，使...简略
show	n. 显示,表现,表演,事情 vt. &vi. 表示,显现,展现,指示
otherwise	adv. 否则,不同地,在不同方面 pron. 其他 adj. 不同的
working	adj. 工人的, 劳动的
delimiter	n. 定界符, 分隔符
