location	n. 地点,位置
perform	v. 执行, 表演, 做
graphic	adj. 生动的,图表的 n. 图表
read	vt.& vi.阅读，朗读； 显示； 研究； 看得懂 vt.显示； 阅读； 读懂，理解 n.阅读； 读物； 读书； 里德（人名） adj.被朗读的； 博识的； 博览的； 有学问的
confirm	v. 确定, 批准, 证实
sort	n. 种类,样子,态度 v. 分类,整理,排序 n.[计算机] DOS命令 : 在字符型文件中进行数据排序, 或者将DOS命令的输出进行排序
clause	n. 分句, 从句, 条款, 款项
once	adv. 一次, 曾经 conj. 一旦 n. 一次 adj. 曾经的
however	adv. 然而 conj. 然而, 可是, 不过
extend	v. 扩充, 延伸, 伸展, 扩展
look	n. 看, 神色, 样子, 脸色 vi. 看, 注意, 朝着, 好象, 显得 vt. 打量, 注视, 用眼神或脸色表示, 期待
now	n. 现在,此刻 adj. 现存的, 目前的 adv. 现在,立刻 conj. 既然 abbr. =National Organization of Women 全国妇女组织
original	adj. 最初的, 原始的; 有独创性的, 原版的 n. 原件, 原稿; 有独创性的人, 怪人
correspond	vi. 符合,通信,相当
property	n. 财产; 性质; 道具
several	adj. 几个,各自的 pron. 若干
learn	vt. 学习,获悉 vi. 了解,习得
cause	n. 原因；事业；目标 vt. 引起；使遭受
bracket	n. 支架, 括号, 档次 vt. 支撑, 放在括号内, 归入一类, 包含, 支持
omit	vt. 省略,疏忽,遗漏
running	n. 跑步;经营,管理 adj. 奔跑的;流动的;运转中的 adv. 连续地
edge	n. 边,边缘,刀口 vt. 给...加上边,缓慢横过,使逐渐丧失 vi. 徐徐前进
form	n. 形式, 形状, 表格 v. 形成, 组成, 建立
instruction	n. 说明,须知,指令,教学
ASCII	American Standard Code for Information Interchange,美国信息互换标准代码
below	adv.在下面，到下面 prep.（表示位置）在…下面； （表示状态）在…掩饰之下； （表示比较）不及； 低于
standard	n.标准，规格； 旗，军旗； 度量衡标准； 直立支柱 adj.标准的，合格的； 普遍的，一般的； 公认为优秀的
occurrence	n. 发生,事件,发现
lock	n.锁； 水闸，船闸； （机器部件等的）锁定； 一把，一撮 vt.锁上； 锁好，关好； 使固定； 隐藏 vi.卡住，不动； 纠结； 僵硬不动
append	v. 附加,添加,悬挂 n.[计算机] DOS 命令建立数据文件的子目录搜索路经
destination	n. 目的地,终点,景点
password	n. 口令，密码
point	n. 点, 要点, 尖端，细节，目标 vt. &vi. 指出, 瞄准
variety	n. 多样, 种类, 杂耍
many	n. 许多人,许多 adj. 许多的 pron. 许多人或物
buffer	n. 缓冲,缓冲区 vt. 减轻,缓冲
useful	adj. 有用的
object	n. 物, 物体, 目标, 宾语 v. 反对，提出...作为反对的理由
again	adv. 又,再,另一方面
carry	n. 搬运, 射程, 投射, 联运 vt. 负载, 运输, 传送, 传播, 表达, 带有, 容纳, 承担, 怀孕, 延续, 推动, 赢得, 记录 vi. 负载, 被传达, 容许被运输, 被通过
update	vt. &vi. 更新,补充最新资料 n. 更新
moving	vbl.移动
coprocessor	协处理器
overlay	覆盖
practice	n. 练习, 实行, 习惯; 业务 vt. &vi 练习, 实习, 开业
navigation	n. 航行, 航海, 导航
automatically	adj. 不经思索的 adv. 自动地
total	adj.总计的（金额等）； 全部的； 完全的； 绝对的 n.总计，总数； 全体数量 vt.& vi.总计达，计算…的总数
previous	adj. 在...之前, 先, 前, 以前的
software	n. 软件
shortcut	n. 捷径 v. 抄近路,走捷径
long	adj. 长的,很久的,冗长的 vi. 渴望,热望,极想 adv. 长期地,远地 n. 长时间,长音节
unique	adj. 独一无二的, 独特的, 稀罕的
part	n. 部份,零件,角色,部位 vt. 分开,分离,分配 vi. 分离,离开 adv. 部份地 adj. 分离的
internal	adj. 国内的, 内在的，身体内部的
fill	vt. 装满,填充,弥漫,担任 n. 足量
basic	adj.基本的； [化学]碱性的； [地质学]基性的； 首要的 n.基础，基本； 基本原则，基本原理，基本规律； 要素； 基础训练
math	n. 数学
since	adv. 后来 conj. 既然,因为,自从 prep. 自从
determine	vt.& vi.（使）下决心，（使）做出决定 vt.决定，确定； 判定，判决； 使决定； 限定 vi.[主用于法律]了结，终止，结束
making	n. 制成 动词make的现在分词
center	n. 中心, 中间, 主角, 中锋, 重点 vi. 居中, 聚焦于... vt. 使集中, 放在中央
already	adv. 已经
keyword	n. 关键字
action	n. 起诉，行为，作用，情节,活动
condition	n. 情况, 条件 v. 以...为条件, 决定, 支配, 训练
quick	adj.快的，急速的； 聪明的，凌厉的； 灵活的； 短时间做成的 adv.迅速地，快速地 n.（指甲下的）活肉； 感情的中枢，感觉最敏锐的地方； 要害，核心
give	vt.& vi.给予； 赠送； 作出 vt.供给； 产生； 举办； （为购买某物或做某事而）支付 vi.（物体）塌下； 让步 n.伸展性，弹性
large	adj. 广泛的,大的,强烈的 adv. 普遍地, 大量地
chapter	n. 章,回,篇,牧师的例行会议,地方分会
computer	n. 计算机
complete	adj. 彻底的, 完整的, 已完成的 vt. 完成; 使圆满, 使完美
past	adj. 过去的 adv. 过 n. 过去 prep. 过,经过
match	n. 比赛, 火柴, 对手, 般配的人, 配偶 v. 使...相配, 与...竞争, 相配
recover	vt.恢复； 重新获得； 找回； <正>恢复（适当的状态或位置） vi.恢复健康（体力、能力等） n.恢复开始时姿势
always	adv. 总是
require	v. 需要, 要求
opening	n. 开始, 口, 揭幕, 空缺的职务 vbl. 打开, 开放, 开始
network	n. 网络,系统,广播网 vt. 用网覆盖,联网 vi. 加入网络
sign	n. 符号, 正负号, 手势, 迹象, 招牌 v. 签, 做手势, 做标记
release	n. 释放, 让渡, 发行 vt. 释放, 让与, 准予发表, 发射
three	num. 三 pron.&amp;adj. 三(个,只...)
recall	vt. 召回；回想起，记起；取消 n. 召回；回忆；撤消
deletion	n. 删除
fixed	adj. 固定的,不变的,准备好的 v. 修理,使...固定,决定 vbl. 修理,使...固定,决定 [计算机] 固定的
amount	n. 数量, 总额 vi. 总计, 等于
alias	n. 别名,化名 adv. 又被称为，另外地
quote	n. 引用 v. 引述, 举证, 报价
correct	adj. 正确的 v. 改正,纠正 vt. 改正
else	adj. 别的, 其他的 adv. 另外,否则
maximum	n. 极点, 最大量, 极大 adj. 最高的, 最大极限的
under	prep. 在...下,在...内,在...控制下,低于 adv. 在...下,在昏迷中,淹没地 adj. 下面的,从属的,少于的
take	vt.拿，取； 采取； 接受（礼物等）； 耗费（时间等） vi.拿； 获得 n.镜头； 看法； 收入额； 场景
element	n. 成分,要素,元素,基本原理,(复数)恶劣天气
modification	n. 修正, 修饰, 修改
input	n. 输入
uppercase	n. 大写字母 adj. 大写的 vt. 用大写字母排版或印刷
plus	prep.（表示运算）加； （表示包容）外加； [口语]和； （表示数目）在零（度）以上 n.加号； [数学]正量； 好处； 附加物 adj.加的； 正的； 附加的； 比所示数量多的
found	vt. 创立，建立；创办 v. 找到（find的过去分词）
debug	v.调试，驱除（某处的)害虫，排除障碍，纠正...的错误，寻出并拆除...内的窃听器
force	n. 力量,武力,暴力,影响力 vt. 施暴,强迫,强夺,加压力 [计算机] 强制
lowercase	adj. 小写体的 vt. 用小写字母书写，用小写字母打字 n. 小写体，小写字母
just	adj. 公正的,公平的,恰当的 adv. 正好,恰好
undo	v. 解开，松开，取消
environ	vt. 包围, 环绕
why	adv. 为什么 conj. …的理由, 为什么 int. 咳, 哎呀 pron. 为何, 为什么
temporary	adj. 暂时的,临时的 n. 临时工
put	vt. 放,安置, 使处于 vi. 提交, 记下
instead	adv. 代替, 反而
encounter	n. 意外的相见,遭遇 vt. &vi. 遇到,偶然碰到,遭遇
across	adv. 横过, 使...被理解(或接受) prep. 穿过, 横过
matching	adj. 匹配的, 相称的 动词match的现在分词
wildcard	n.[计]通配符
spill	vt.& vi.溢出； 泼出； 涌出； 蜂拥而出 n.洒出； 泼出； 溢出；小塞子
level	n. 水平,等级,标准,层次 adj. 平坦的,齐平的,稳定的,合理的,满满的 vt. 压平,使同等,瞄准,夷为平地,推翻, 指责 vi. 趋向平稳, 瞄准, 诚恳待人, 使平等
browse	vt. &vi. 浏览, 随意观看, 吃草 n. 浏览, 嫩叶
speech	n. 演讲,对话,话语,语言
occur	vi.发生； 出现； 闪现
memo	n. 备忘录
prior	adj. 更重要的, 较早的, 在先的 adv. 居先 n. 小修道院院长; 大修道院副院长
loaded	adj. 有负载的(装着货的, 装有弹药的, 加重的) v. 装载
length	n. 长度,篇幅
round	n. 圆,(某种圆形)交谊舞,常规活动,一局(轮) adj. 圆的,微胖的,完整的,坦率的,圆满完成的 adv. 环形地 vt. 弄圆,绕行,使...完全,使成为整数 vi. 变圆(胖),弯曲 prp. 围绕,遍及
variant	n. 变体 adj. 不同的
floppy	adj. 叭塌叭塌响的,懒散的,邋遢的
machine	n.机器，机械； 机械般的人； 核心 vt.用机器制造，用机器加工 vi.被机器切削
square	n. 正方形,街区,平方，广场 adj. 正方形的,正直的,公正的,结实的 vt. 使...成方形,调整，一致 vi. 符合 adv. 成直角,直接的,正方形地
supply	n. 补给,供给,供应，贮备 vt. 补给,供给,提供,提供足够以满足
home	adj. 家(乡)的 adv. 回家, 在家, 正确的方向 n. 家, 住所, 国内的, 养老院 vt. 提供住处 vi. 回家, 移向
normal	adj. 正常的,正规的 n. 常态, 标准
onto	prep. 到...上
during	prep. 在...期间
module	[计算机] 模块 n. 组件
monochrome	n. 单色画,单色画法 adj. 单色的,黑白的 [计算机] 单色的
assistance	n. 帮助, 援助
tell	vt. 告诉,说,知道,认出,计数 vi. 讲述,告发,作证,产生效果
library	n. 图书馆, 藏书
demonstration	n. 示范,实证,表达,集会
stack	n. 堆叠,堆 vt. 堆积,成叠放在 vi. 堆成一堆
even	adj. 平坦的, 偶数的, 相等的 adv. 甚至, 恰好, 正当 v. 使平坦, 相等
evaluate	vt. 评估,评价
times	n. 时间,期限,次数,乘 vt. 为...安排时间,计时,定时,乘 [计算机] DOS命令 : 显示并允许改变系统时间 adj. 根据时间的, 时间上的
previously	adv. 以前(预先)
directly	adv. 直接地(立即,完全)
logical	adj. 符合逻辑的,逻辑上的,有推理能力的
template	n. 模板,样板
calling	n. 职业, 行业, 邀请 召集
later	adj. 更迟的,后面的 adv. 稍后,后来, 迟到地
driver	n. 驾驶员, 司机
therefore	adv. 因此, 所以
saving	n. n. 节约，挽救 （复数)savings:储蓄金，存款
detail	n. 细节,详情,部分,分派 vt. 详述,选派,用小元素装饰 vi. 画细节
linker	[计] (目标代码)连接器
loop	n. 环,圈,弯曲部份,回路 vt. 使...成环,以圈结,以环连结 vi. 形成环,环形地行动
process	n.过程； 工序； 做事方法； 工艺流程 vt.加工； 处理； 审阅； 审核 vi.列队行进 adj.经过特殊加工（或处理）的
scheme	n. 方案, 计划, 阴谋 v. 计画, 设计, 体系, 结构, 图谋
every	adj. 每,每个,每隔...的
refer	vt. 把…提交; 把...归因, 归类为 vi. 谈及, 咨询, 参考
possible	adj. 可能的
above	adj. 上面的 adv. 在上面, 超过 n. 上面的东西 prep. 在...上面, 超过
overview	n. 概观(况),总结 [计算机] 概貌
result	n. 结果,成绩,答案 v. 产生,起于,致使
syntax	n. 句法
abbreviation	n. 缩写
BIOS	abbr. (=Basic Input Output System)基本输入输出系统
hidden	adj. 隐藏的, 秘密的 vbl. 藏着, 隐藏, 躲藏 [计算机] 隐藏的
null	adj. 无效力的,无效的,无价值的 n. 零 [计算机] 空 vt. 使无效
send	vt. 送给,传,寄，发射 vi. 放送 n. 波浪的推力
private	adj. 私人的，隐蔽的 n. 士兵，列兵
hard	adj. 坚硬的;艰难的,苛刻的 adv. 努力地,猛烈地,坚定地
hardware	n. 五金器具 n. (计算机) 硬件
say	vt. 说,讲,表达,假设,,指示 vi. 说 n. 发言权 adv. 大约
equal	adj. 相等的,平等的,胜任的 n. 对手,匹敌,同辈 vt. 等于,比得上
pack	n. 包裹,一群,一副,一帮,一群 vt. 包装,捆扎,塞满, 收拾行李， 佩戴 vi. 包装，（用某物）保存，保藏 ,塞进
minus	adj. 负的,减的 n. 减号,负数,缺点 prep. 减去
alternate	adj. 交替的, 轮流的, 间隔的 vt. &vi. 交替, 轮流
collapse	n. 崩溃,倒塌,暴跌 vi. 倒塌,崩溃,瓦解,折叠 vt. 倒塌,缩减
linux	一种可免费使用的类UNIX操作系统