corner	n.角落，角； 拐角； 困境； [商]囤积 vi.驾车转弯； 聚于角落 vt.垄断； 逼入困境 adj.位于角落的
present	n. 礼物, 现在 adj. 当面的, 出席的, 现在的 v. 赠送, 提出, 呈现
interpreter	n. 译员,口译者，解释程序
advance	n. 前进,进步,预支 vt. 前进，增涨，预先 vi. 前进，提升 adj. 预先的，提前的
forward	adv.前进地； 向前； 至将来； 提前地 adj.向前方的； 迅速的； （社会、政治）进步的； 早熟的 vt.促进，助长； （按新地址）转寄； 发送 n.前锋
fast	adj.快的； 走得快； 感光快的； 紧的 adv.（比准确的时间或宣布的时间）快； 迅速地； 紧紧地； 彻底地 vi.禁食，（尤指）斋戒 n.禁食期，斋戒期； 断食，节食
special	n. 专辑,专车,特色菜,特价,特刊 adj. 特别的,专门的
slash	vi. 大幅度削减 vt. 猛砍,尖锐抨击,大幅减少 n. 猛砍,斜线,长切口,衣衩
utility	n. 公共设施,效用,公用程序,实用品,实用 adj. 多效用的，多功能的
regardless	adj. 不注意的, 粗心的 adv. 不顾
disable	v. 使...失去能力
compatible	adj. 能共处的,可并立的,适合的, 兼容的 n. 兼容
depend	vi. 依靠,相信,指望
empty	adj. 空的,空虚的,空腹的 n. 空物 vt. 使...空 vi. 变空,流入
alphabetical	adj. 按字母表顺序的
branch	n. 分支,树枝 vt &vi. 分支, 分岔
resume	v. 再继续, 重新开始 n. 简历, 履历; 摘要
multiple	adj. 许多,多种多样的 n. 倍数,并联
monitor	n. 监督器, 班长, 监听员, [计算机]显示器, 监视器 v. 监视, 监听, 监督
configuration	n. 结构,布局,形态,格式塔心理完形 [计算机] 配置
replacement	n. 交换,更换,代替者
required	adj. 必需的
table	n. 桌子, 平地层, 石板, 表格 vt. 搁置, 嵌合, 制表 adj. 桌子的
loss	n. 丧失, 损耗, 亏损
exact	adj. 精确的 vt. 强求,要求,索取
aboveboard	adv. 光明正大地, 率直地 adj. 光明正大的, 率直的
activate	v. 刺激,使...活动,创设
around	adj. 大约, 在现存范围内 adv. 大约,到处,在周围 prep. 在...附近, 到处
slow	adj. 慢的 adv. 慢慢地 vt.& vi. 放慢,减速
floating	adj.浮动的，流动性的，不固定的 动词float的现在分词形式
refresh	vt.& vi. 使...生气蓬勃,提起精神,恢复精神
stop	n. 停止,车站,滞留,阻挡 vt. 停止,制止,塞住 vi. 停止,停留,结束
pass	vt.& vi.走过； 通过； 批准； 度过 vt.传球； 及格； 发生； 不要 n.通道； 通行证； 关口； 越过
public	adj. 公开的,众所周知的,公众的 n. 公共场合,公众,同好者
eject	vt.喷出； 驱逐； 强制离开 vi.弹射出
ignore	vt. 不顾,不理,忽视
share	n. 部份,股份,分担,犁头 vt. 分享,共有,分配 vi. 分享
sequence	n. 序列, 一系列, 顺序, 一组镜头 vt. 安排顺序
consist	n. 组成 vi. 组成,存在,一致
step	n. 步骤,步伐,踏级 vt. 踏,以步测量
double	n. 两倍,复制品,替身,双重角色的演员,反转,双人房 adj. 两倍的,双重的,骗人的,加量的 adv. 两倍地,双人地,翻来覆去地,对折地 vt. 使加倍,对折,握紧,做替身 vi. 加倍,转身,兼任,替代演出
come	vt. 接近，扮演 vi. 来，发生，达到，进入
lower	adj. 低的, 下级的, 下层的 vt. 降低, 跌落, 减弱, 贬低 vi. 皱眉, 降低, 阴沉, 变少 n. 皱眉, 下级, 阴沉的样子, 前兆
describe	vt. 描述, 画(尤指几何图形)
count	v. 计算, 视为, 依赖 n. 计数
pop	n. 取出,砰然声,流行乐曲,流行文化艺术,（尤用作称呼）爸 adj. 流行的,热门的,通俗的 vt. 取出,发出爆裂声,突然伸出,击打,开火 vi. 发出砰的一声，（因激动、惊奇）张大 adv. 突然间地, 暴发地 POP abbr.=point of purchase POP abbr.=population 人口
valid	adj. 有确实根据的; 有效的; 正当的, 合法的
suspend	v. 推迟,悬(浮),挂,暂停,取消 vi. 吊,悬浮 vt. 悬,挂,吊,暂停,中止
enhance	vt. 提高,加强,增加
separate	n. 分开, 抽印本 adj. 分开的, 各自的, 单独的 v. 分开, 隔开, 分居
echo	n. 回声,回音,回波,反响,共鸣 vt. 发回声,回响, 重复, 仿效 vi. 回响, 回荡 n.[计算机] DOS命令 :禁止(或允许)批处理命令行显示屏幕上
necessary	adj. 必需的,必要的,必然的 n. [pl.]必需品
able	adj. 能干的, 有能力的
marking	n. 印记, 作记号，打分 动词mark的现在分词
ask	vt. 询问, 请求，要求，开价 vi. 询问，恳求
term	n.学期； 条款； 术语； 期限 vt.把…称为； 把…叫做
bring	vt. 带来, 引起, 促使, 劝诱 vi. 产生
warning	n. 警告, 预告, 通知 vbl. 警告, 注意, 通知
less	adj. 更少的,更小的 adv. 更少地,更小地 n. 少量, 次要 prep. 减
comment	n. 注释, 评论; 闲话 v. 注释, 评论
effect	n. 结果, 影响, 效果; 要旨 vt. 招致, 引起; 实现, 达到
expanding	adj.展开的,扩大的
on-line	adj.在线的,即时的
reorder	重新排序, 再定购
direct	adj. 笔直的,直接的,坦白的 vt. 指挥，命令，负责 vi. 指导，指出
enclose	vt. 围绕, 圈起, 放入封套, 附上 [计算机] 括入
reset	n. 重新设定, 重新组合 v. 重新设定, 重新放置, 重新组合
various	adj. 各种各样的
paper	n. 纸,文件,论文,报纸,票据 vt. 用纸包,供纸,仓促完成 vi. 贴壁纸 adj.纸制的,文书的,理论上的
prevent	v. 预防, 防止
side	n. 旁边,侧,方面 adj. 旁的,侧的 vt. 支持,同意 vi. 支持
push	n. 推,奋力,决心 vt. &vi. 推,挤,逼迫
programming	n. 程序设计, 编程 动词program的现在分词
upper	adj. 上部的,地位较高的,上面的,北方的 n. 鞋帮,上牙,兴奋剂,令人愉快的经历
row	n. 排,船游,吵闹 vt. 划船,成排 vi. 划船,吵架
pressed	adj. 被压迫的，压缩的 动词press的过去式和过去分词
temporarily	adj. 临时的 adv. 暂时地,临时地
day	n. 白天,一天
repaint	v.重漆,重画 v.重新绘制
redefine	vt. 重新定义
relation	n. 关系,家人,亲戚,叙述,陈述
dimension	n. 尺寸, 次元, 容积, 维度 n. 范围; 方面 vt. 标尺寸; 形成...尺寸
boundary	n. 分界线, 边界
zoom	vi.嗡嗡作响； 急速上升 n.嗡嗡声； 隆隆声； （车辆等）疾驰的声音； 变焦 vt.使急速上升； 使猛增
initialize	vt. 初始化
personal	adj. 私人的,个人的 n. (报刊的)私人专栏
true	adj. 确切的,可靠的,真实的,正确的,正式的 adv. 笔直地,事实地 n. 真相,精确 vt. 使...平衡
wish	n. 渴望,愿望,(复数)祝颂,命令 vt. &vi. 想要,希望
font	n.字体； 字形； 圣洗池（设于教堂中，常为石造）
know	vt. &vi.知道,了解,认识
convert	v. 使转变, 使...改变信仰, 倒置 n. 皈依者, 改宗者
global	adj. 全球性的, 全局的
installation	n. 安装,装置, 军事驻地
invoke	vt. 求助,用咒语召唤,请求,应用,引起 [计算机] 调用
interactive	adj. 相互作用的 [计算机] 交互的
century	n. 世纪，一百年，成百的东西
literal	adj. 逐字的, 字面上的, 文字的 [计算机] 文字的
rather	adv. 宁可,宁愿,有些,相当,反而
exclusive	adj. 独占的, 唯一的, 排外的; 高价的, 时髦的 [计算机] 互斥的 n. 独家新闻, 独权
marker	n. 标记，做记号的工具,做记号的人,记分员
wait	vt.& vi.等候； 等待； （尤指长期地）希望； 盼望 vi.准备妥； 在手边； 可得到； 可使用 vt.推迟，搁置，延缓
appropriate	adj. 适当的, 相称的 vt. 拨出(款项); 占用
fit	adj. 适宜的,对的,准备好的 v. 适合,安装 n. 适宜,发作,一阵
adapter	n. 适配器 n. 改编者
filter	n. 筛选,滤波器,过滤器,滤色镜 vt. &vi. 过滤,渗透 [计算机] 过滤
break	n. 休息,中断,破裂 v. 打破,弄破,弄坏
backward	adj. 向后的 adv. 向后
searching	adj. 探寻的，洞察的 动词search的现在分词
receive	vt. 收到,接受,迎接,容纳,遭受,相信 vi. 接到,获得
dual	adj. 双重的, 成双的 n. 双数
retry	vt. 重试
normally	adv. 正常地,通常地
exactly	adj. 完全的 adv. 恰好地,正好地,正确地,精确地,正是
immediately	adv. 立即,直接地 conj. 一...(就)
separated	adj. 分开的 动词separate的过去式和过去分词
high	adj.高的,轻微变质的,高尚的,严重的,强的 adv. 高,好 n. 高地,天堂,高气压,高度,兴奋
equivalent	adj. 等价的, 相等的 n. 相等物
light	n. 光,光线,灯,启发,众所周知的,通光口,眼光 adj. 轻的,不重要的,容易的,明亮的,淡色的 vi. 点燃,着火,变亮,下马,落下,碰巧发生 vt. 点燃,照亮 adv. 轻地,轻便的
zero	num.&amp;n. 零
storage	n. 储存体, 储藏, 仓库, 保管费
width	n. 宽度,广度,某一宽度的材料
language	n. 语言
startup	n. 开动, 出发
much	adj. 许多的 adv. 很,非常 pron.&amp;n. 许多
per	prep. 每,每一 adv.每人
over	prep.（表示方向）越过； （部份或全部覆盖）在…上面； 由于； （表示论及）关于 adv.结束； 再； （倒）下； 从一边至另一边 adj.过去的； 外面的； 在上的； 上级的 n.额外； 剩余； 剩余（或多余）的量； 剩余物
mirror	n. 镜子 vt. 反映,反射
request	n. 要求, 请求 vt. 请求, 要求
keypad	n. [计算机]小键盘
keep	vt.保持； 保留； 遵守； 阻止 vi.（食品）保持新； 保持健康 n.保持，保养； 供养，抚养； 生活，生计； 饲料；牧草
resident	adj. 居住的 n. 居民,旅客
learning	n. 学问, 学识, 学习 动词learn的现在分词
talk	n. 谈话,会谈,讲话, 闲话 vt. 说, 谈论, 商讨 vi. 说闲话, 招供, 开口说话, 闲聊
summary	n. 摘要,概要 adj. 摘要的,简略的
well	n. 井,源泉,楼梯井 adj. 健康的,良好的,适宜的 adv. 很好地,适当地 vi. 涌出 interj. 好吧,啊
link	n. 环节,联系, (链的)环, 圈 vt. &vi. 连接,联系
identify	vt.识别，认出； 确定； 使参与； 把…看成一样 vi.确定； 认同
pertain	vi. 从属, 关于
expansion	n. 扩大,膨胀,扩充
incompatible	adj. 不相容的, 不能并存的, 矛盾的
blinking	adj. 闪烁的 adj. 该死的, 讨厌的, 十足的 动词blink的现在分词
month	n. 月
precede	vt. &vi. 在...之前,优于,较...优先
readily	adv. 不迟疑地,迅速地,轻易地
transportable	便携式计算机, 可传送的
routine	n. 例行公事, 常规，无聊 adj. 常规的, 例行的，乏味的
ready	adj. 准备好的,乐意的,情愿的，现成的 vt. 做好…的准备
listing	[计算机] 清单
newly	adv. 崭新,新改,以新方法
year	n.年； 年纪； 一年的期间； 某年级的学生
contact	v. (与)联系, (与)接触 n. 接触, 联系; 联系人
session	n.开会，会议；（法庭的）开庭； 会期，学期； （进行某活动连续的）一段时间
own	adj. 自己的, 嫡亲的 pron. 自己的 vi. 承认 vt. 拥有, 承认
redraw	v. 重划
here	adv.在这里； 这时； 在这一点上； （给某人东西或指出某物时说） n.这里 int.喂； 嗨
manual	adj. 手工的,体力的 n. 手册,指南,键盘
particular	n. 个别项目, 详细说明 adj. 特别的, 独有的; 挑剔的; 详细的
rectangle	n. 长方形,矩形
additive	n. 附加物(加法) adj. 加添的
similar	adj. 相似的,类似的,相同,一样
assembly	n. 集合, 集会, 装配
copyright	adj. 版权(的) n. 版权,著作权
description	n. 描写, 描述, 说明书, 作图 n. 类型
retrieve	vt. 挽回,恢复,回忆,补偿 vi. 找回猎物 n. 取回,恢复
mistake	n. 错误,误会 vt. 弄错,误认 vi. 犯错
produce	n. 产品, 农作物 vt. 生产, 提出, 引起, 分娩, 制片 vi. 生产, 制造
ram	abbr. 随机存取存储器（random access memory的缩写）；随机访问内存（random-access memory的缩写） n. 公羊；撞锤；撞击装置；有撞角的军舰；（水压机的）[机] 活塞 v. 撞击；填塞；强迫通过或接受
exception	n. 除外,例外
digit	n. 数字,位数,指头
reverse	n. 相反; 背面; 失败, 挫折 adj. 反面的, 相反的, 颠倒的 v. 颠倒, 逆转, 倒退
minimum	adj. 最低的, 最小的 n. 最小量, 最低限度
enough	adj. 足够的 adv. 足够地 n. 充足,足够 pron. 足够(的)
although	conj. 尽管, 虽然
third	adj. 第三(的) n. 三分之一 num. 第三
red	adj. 红色的 n. 红色
along	adv. 向前,(与某人)一道 prep. 沿着
test	n. 测试, 试验 vt. 测试, 试验, 接受测验, 测得... adj. 测试的
small	adj. 小的,少的 adv. 些许地 n. 狭小部分
feed	vt.喂养； 满足（欲望等）； 向…提供； 供…作食物 vi.吃，以…为食； 流入，注入，进入（如油流入机器）； [电子学]馈入 n.饲料（尤指粗饲料），施肥； 喂送； 草料
company	n. 同伴,客人,一群,连队,公司 vt. 陪伴 vi. 联合
movie	n. 电影
compile	v. 编译,编辑,编纂 [计算机] 编译
frequently	adv. 经常地, 频繁地
undefined	adj. 未定义的
state	n. 州, 国, 情形 adj. 国家的, 州的, 正式的 vt. 说, 陈述, 声明, 规定
accept	vi.承认； 同意； 承兑 vt.接受； 承认； 承担； 承兑
intense	adj. 非常的,强烈的,紧张的,热情的
documentation	n. 文件
asterisk	n. 星号(*)
easily	adj. 容易地,不费力地 adv. 容易地
become	vt. 变得 vi. 存在,变得,经历改变或发展
address	n. n.地址； 通信处； 演说； 称呼
interface	n. 界面,接触面 vt. 连接,作接口 vi. 连接
pause	n. 暂停,中止,犹豫不决 vi. 停顿,中止 vt. 使停顿
repeat	n. 重复,反复 vt. 重复,复述 vi. 重复 adj. 重复的,反复的
restart	重新启动
assumed	adj.假定的, 假装的 动词assume的过去式和过去分词
speed	n. 速度,迅速,感光度,超速 vt. 加速,催促,促进 vi. 超速,加速,进展
entry	n. 进入,入口,登记,项目
combine	n. 集团,联合收割机 v. 化合,结合,联合 vi. 结合,联合 vt. 使结合,使联合