root	n. 根,根源,祖先 vt. &vi. 生根,扎根,翻寻,起源于
symbol	n. 符号, 标志, 象征
binary	adj. 二进位的,二元的 n. 二进制,二元
whenever	adv. 无论何时 conj. 每当, 无论何时, 随时
reach	n. 延伸,范围,河段 vt. 到达,伸出,延伸,取得联系 vi. 延伸
caution	n. 警告,戒备措施,慎重,吸引人眼球的物品或人 vt. 警告
subtotal	n. 小计 adj. 不完全的
card	n. 卡片,纸牌,名片,打牌,节目单 vt. 附上或提供卡片,印卡,在卡片上列出,检查资格
general	n. 一般,将军,大体 adj. 一般的,普遍的 v. 指挥,作...将军
associated	adj. 联合的,相关的
transfer	n. 迁移, 移动, 换车 v. 转移, 调转, 调任
connect	vt. 连接,联通,使有联系 vi. 连接,接通
partition	n. 分割,隔离物,隔墙 v. 区分,隔开,分割
hexadecimal	adj. 十六的, 十六进制的 n. 十六进制
generate	vt. 产生,发生,引起 [计算机] 产生
specification	n. 规格,详述,详细说明书
customize	vt. 定制 [计算机] 用户化
far	adv.&amp;adj. 远的(地) n. 远处
nest	n. 巢, 窝 vt. 嵌入 vi. 筑巢
duplicate	n. 副本,复制品 adj. 复制的,二重的 vt. 复制,重复 vi. 重复 [计算机] 复制
compression	n. 压缩, 压榨, 缩小
unable	adj. 不能的,不会的 v. 不能,不会
means	n. 方法,手段，折中点，物质财富
intensity	n. 激烈,强度,强烈,剧烈
reading	adj. 阅读的 n. 阅读
let	vt. 让,容许,释放 vi. 出租,承包 n. 障碍,擦网球
compare	vt.&vi. 比较,比喻,对照 n. 比较，对照
sector	n. 扇形,扇区,部门,区域 vt. 分区
problem	adj. 成问题的, 难对付的 n. 问题
backspace	vi. 按退格键 n. 退格键
terminate	adj. 有结尾的,有限的 vt. 结束,终止,满期 vi. 达到终点
people	n. 民族,人,人们,人民,家人 vt. 居住于
short	adj. 短的,矮的,短暂的 n. 短裤 adv. 短暂地;突然地
drag	n. 用来拖拉的东西,拖,拖累 vt. 拖累,拖拉(动) vi. 拖拉(动),缓慢地行走
preview	n. 预审,查阅,预习,预告 vt. 事先查看,查阅,预审,预习
underscore	vt. 划线于,强调,提供伴奏乐 n. 下划线,影片伴奏乐
correctly	adv.恰当地,正确地
initially	adv. 最初, 开头
reformat	vt. 重定格式, 重新格式化
inside	adj. 里面的 adv. 在里面 n. 内部 prep. 在...里面
integrate	v. 整合, 使...成整体
controlled	adj. 受控制的, 受约束的 动词control的过去式和过去分词形式
period	n. 学时, 课时; 一段时间, 时期, 周期; 句号
huge	adj. 巨大的,程度高的
determined	adj. 坚毅的,下定决心的
trailing	adj. 牵引的 n. 拖尾 动词trail的现在分词形式
seek	n. 找寻 v. 寻求,寻找,搜索
introduction	n. 介绍, 引进, 导论, 序言
indent	n. 契约, 订货单 v. 切割成锯齿状, 缩排, 定货 [计算机] 缩排, 缩进
base	n. 基底,（支持、收入、力量等的）基础 vt. 以...作基础 adj. 卑鄙的；不道德的
integer	n. 完整的事物,整体,整数 [计算机] 整数
attempt	vt.试图； 尝试 n.进攻； 尝试，冲击
twice	adv. 两倍, 两次
formed	adj. 成形的 动词form的过去式和过去分词
subscript	n. 下标 adj. 写在下方的
tiny	adj. 极小的,微小的
model	n. 模型, 模范, 模特儿 adj. 模范的, 作模型用的 v. 做模型, 塑造, 模仿
correction	n. 订正, 改正, 改正的地方
rating	n. 等级,评定,收视率
secondary	adj. 中级的,中等的,次要的 n. 次要位置, 副手
limit	n.限制； 限量，限度； 界限 vt.限制，限定
sun	n. 太阳,阳光,中心人物,像太阳般的东西 vt.& vi. 晒太阳
translate	vt. 翻译；转化；解释；转变为；调动 vi. 翻译
reason	n. 理由,原因,理智,理性 vt. 说服,总结 vi. 规劝,下判断
colon	n. 冒号, 结肠, 科朗(哥斯达黎加和萨尔瓦多的货币单位) (Colon)科隆(巴拿马港市)
avoid	v. 避免 vt. 避免,逃避
range	n.范围； 射程； 类别； （山脉，房屋等的）排列 vi.搜索； 变化； 延伸； 漫游 vt.排列； （按一定位置或顺序）排序； 把…分类； 徘徊 adj.牧场的，放牧区的
allocate	v. 分派, 分配, 分配额
simply	adv.&amp;adj. 简单地,仅仅
verify	v. 查证,核实 n.[计算机] DOS命令 : 打开关闭在 DOS操作期间的写文件校验开关
manner	n. 样子,礼貌,风格,方式
direction	n. 方向,指导,用法说明,趋势
portion	n. 部分,份,命运 v. 将...分配,分配
emulator	n. 仿真器
successful	adj. 成功的,达到目的的
applied	adj. 应用的 v. 应用, 适用 vbl. 应用
sum	n. 总数(计),金额,顶点,概略,一笔钱 vt. 总计,概括 vi. 总计
achieve	vt. 完成,达到,实现 vi. 达到目的
together	adv. 一起，共同，相结合，同时地，协调地 adj. 头脑清楚的，镇定的
affect	vt. 影响, 作用, 感动
delay	n. 耽搁,迟滞 vt. 耽搁,延迟 vi. 耽搁
free	adj. 自由的,大方的,免费的 vt. 释放,解放 adv. 自由地,免费地
properly	adv. 适当地, 相当地, 当然地
kind	adj. 仁慈的,友好的 n. 种类,本质
splitting	爆裂式的
feature	n. 特征, 容貌 vt. 以...为特色 vi. 起重要作用
console	vt. 安慰,慰藉 n. 仪表盘,操控台,(游戏)平台
operate	vi. 操作, 运转 vt. 起作用, 动手术
kernel	n. 核心, 中心, 精髓 [计算机] 核心
easy	adj. 容易的,安逸的,不费力的 adv. 慢慢地, 当心地
modifier	n. 修正的人, 修饰语
invalid	adj. 无效的,伤残的 n. 病人,残疾者 vt. 失去健康
compiler	n. 编辑者，[计算机]编译器, 编译程序
dot	n. 小圆点,少量,小东西 vt. 作小点记号,点缀 vi. 作小点记号 [计算机] 点
beep	n. 哔哔声 vt. 产生（如号角）声音 vi. 吹号，发出哔哔声
face	n. 脸, 神情, 面子, 表面 vt. 面对, 朝 vi. 朝, 向
random	n. 随意,任意 adj. 任意的,随便的,胡乱的 adv. 随机地
facility	n.设备； 容易； 能力； 灵巧
heading	n. 标题，题目，航向 动词head的现在分词
asynchronous	adj. 异步的
series	n. 系列，连续
individual	adj. 个别的; 独有的 n. 个人, 个体
explain	vt. &vi. 解释,说明
paste	n. 糊,浆糊,铅制玻璃 vt. 粘贴,覆盖,猛击
welcome	vt.欢迎； 乐于接受 adj.受欢迎的； 令人愉悦的； 表示感谢的 n.欢迎，迎接
six	n.六；六个；六岁；六点 num.六；六个
early	adv.&amp;adj. 早
wrap	vt.包； 缠绕； 用…包裹（或包扎、覆盖等）； 掩护 n.膝毯，披肩，围巾，围脖，头巾，罩衫，外套，大衣； 包装纸； 〈俚〉机密 vi.缠绕，盘绕（通常与 over, around 等连用）； 包上，裹上； 穿上（衣服等）
blue	adj. 蓝色的,沮丧的,忧郁的,(女人)有学问的 n. 蓝色 vt. 使...变蓝 vi. 变蓝
queue	n. 行列,长队 v. 排队 vi. 排长队
interrupt	n. 中断 vt. 打断,妨碍 vi. 插嘴 [计算机] 中断
respect	n. 尊敬, 敬重; 关系, 方面 vt. 尊敬, 尊重; 关于, 涉及
common	adj. 共同的, 平常的, 普通的 n. 平民, 普通, 公地, 公园
hyphen	n. 连字号 v. 以连字号连接
serial	n. 序列，串列 adj. 连续的，一连串的
loading	n.装载,装填
retain	vt. 保持, 保留; 记住
setup	n. 装备, 组织, 计划
freeze	v. 冻结, 冷冻, 僵硬 [计算机] 冻结
intend	v. 打算 vt. 想要,打算,计划
explanation	n. 解释, 说明
certain	adj. 一定的 pron. 某几个,某些 肯定的,无疑的,必然发生的
zap	vt. 击溃，射杀 vi. 快速移动 int. 嚓(表示枪声等）
archive	n. 档案,档案馆 vt. 存档
negative	adj. 否定的,负的,消极的 n. 底片，负数，否定 vt. 否定
image	n. 图像,影像,肖像,想像,形象 vt. 想像,描绘,反映
platform	n. 平台,月台,讲台,坛,计划
often	adv. 经常
signal	n. 信号,导火线,动机 vt. 发信号,标志 vi. 发信号 adj. 显著的
CPU	abbr. [计算机]中央处理器(=central processing unit)
bit	n. 一点儿,少量 n. 钻头,马嚼子,辅币 n. 位,比特(二进位制信息单位) v. 控制
fully	adv. 十分地, 完全地, 全
deactivate	vt. 使无效，使不活动，解散部队
especially	adv. 特别,尤其
usually	adv. 通常
recommend	vt. 建议, 推荐, 劝告 vt. 使成为可取, 使受欢迎
maintain	vt. 维持; 维修, 保养; 坚持; 断言
important	adj. 重要的,影响很大的
central	adj. 中心的,基本的,折中的,中枢的 n. 电话交流,中央办公室,中心
addition	n. 增加,附加物,加,加法
anytime	adv. 任何时候；无例外地
analyst	n. 分析家
false	adj. 不真实的,错误的,人造的,假的,虚伪的 adv. 不真诚地,虚伪地
black	adj.黑（色）的； 黑色人种的； 黑暗的 n.黑色； 黑人； 黑颜料； 黑暗 v.使变黑； 抵制； 拒绝； 使变黑暗
gather	vt.收集； 聚集，搜集； 收紧，收缩； 采集 vi.逐渐增加，积聚 n.聚集； 衣褶
cycle	n. 循环,周期,长期,圈,套曲,自行车, vt. 环行,骑自行车 vi. 使环行
relative	adj. 相对的,比较的,涉及到的 n. 亲属,同类事物,相关物
offer	n. 出价, 提议 vt. 提供, 出价; 贡献, 奉献 vi. 提议; 出现; 求婚
ending	n. 结尾, 结局
rent	n. 租金 v. 租 vi. 出租 vt. 出租,租用
sentence	n. 句子,意见,宣判,刑罚,命题 vt. 宣判,判决,使遭受
remember	vt. &vi. 记得,记忆
proper	adj. 适当的,正确的,合适的,正当的,规矩的
design	vt.& vi.设计； 绘制 vt.设计； 计划； 企图； 决意（做） n.设计； 图案； 结构； 计划 vi.设计略图； （为工艺品、装潢项目等）设计； 当设计师； 构思
examine	vt.检查，调查； 考试； 诊察； 审问 vi.检查； 调查
initial	n. (词)首字母 adj. 开始的, 最初的, 字首的 vt. 签姓名的首字母于
corrupt	adj. 腐败的,堕落的 vt. 使...恶化,贿赂,使...腐烂 vi. 腐烂,堕落
buy	n. 合理的价格,购买 vt. 买,换得,收买,接受 vi. 购买
increase	v. 增加, 提高 n. 增加, 增强, 提高
host	n.[计算机]主机； 主人，东道主； 节目主持人； 酒店业主 vt.当主人； 主办宴会，主持节目； 款待，做东 vi.做主人，做东道主
sample	n. 样品,标本 vt. 采样,品尝 adj. 样例的
pending	adj. 待定的,即将发生或来临的 prep. 直到,等待...的时候,在...期间
divide	vt.& vi.分； 划分； 分离； （使）产生分歧 n.分水岭，分界线； 分配
boot	n. 靴子,[英]汽车行李箱,猛踢, 锁扣 vt. 踢, 穿靴子,锁车 vi. 启动（计算机),在（通常为非法停放的汽车）车轮上装制动装置, 利用, 帮助
hide	vt.隐藏； 躲避，隐匿，躲藏； 遮蔽，覆盖 vi.隐瞒； 遮住； 遮挡； 掩盖 n.兽皮； <口>生命； <口>人的皮肤； （观看野生动物的）隐蔽处
half	adj. 一半的, 不完全的 adv. 一半地 n. 半, 一半
magenta	n.&amp;adj. 紫红色(的染料)
leading	n. 领导, 疏导, 铅板 adj. 领导的, 主要的, 在前的 vbl. 领导, 引领, 以铅接合 [计算机] 行间空白
wrong	adj. 错误的,不正当的,失常的 adv. 错误地 n. 错误,不公正 vt. 伤害,亏待,欺骗,中伤
today	n.&amp;adv. 今天
least	adj. 最少的,最小的 n.&amp;adv. 最少,最小
opposite	adj. 相对的, 相反的, 对面的 n. 对立物，对立者，对手 adv. 在对面地，处于相反位置地 prep. 在...对面
white	adj. 白色的,白种的,纯洁的,幸运的 n. 白色,白种人
override	vt. 弃绝,渺视,凌驾,过度负重 n. 给代理人的佣金,滥用 [计算机] 废除
brown	adj. 褐色的,棕色的 n. 褐色,棕色 (姓)布朗
hex	v. 施法，诅咒 n. 施法的人 abbr. (=hexagon) 六边形 abbr. (=hexadecimal) 十六进制
rest	n.休息； 剩余部分； 支持物； 宁静，安宁 vt.& vi.（使）休息； （使）倚靠[支撑] vi.休息； 静止； 停止； 安心 vt.使休息； 使轻松； 使长眠； 使依赖
damage	n. (pl.)赔偿金,损坏,毁坏 vt. 损害,毁坏
instant	n. 立即, 瞬间 adj. 立即的, 即时的
reserved	v. 保留(预定,推迟) adj. 保留的(预订的,冷淡的,缄默)
technology	n. 技术,工艺(学)
handle	n. 柄,把手 vt. 买卖,处理,操作 vi. 驾驭
apply	vt. 应用, 申请; 涂 vt. 使专心从事 vi.申请; 有关联
stand	n. 站立,停顿,楼台,货摊 vi. 站立,位于，停滞 vt. 忍受,使站立
payment	n. 支付, 付款
kilobyte	n. [计]千字节(1024字节)
parenthesis	n. 圆括号, 插入语, 插曲，间歇,停歇
scan	vt. 扫描；浏览；细看；详细调查；标出格律 vi. 扫描；扫掠 n. 扫描；浏览；审视；细看
developer	n. 开发者，显影剂
murder	n. 谋杀,危险物 vt. 谋杀,折磨,损坏 vi. 谋杀
flush	n. 流溢, 面红, 旺盛, 冲水(尤指冲马桶), 突然萌发, (纸牌)同花顺, 清一色 [计算机] 冲洗 vi. 脸发红, 冲刷, 旺盛成长 vt. 用水冲洗, 惊起(一群鸟), 抄...老窝, 使兴奋 adj. 丰足的,齐平的,满盈的 adv. 正直地, 羞涩地
unlock	vt. 开启, 显露, 放开
movement	n. 活动,运动,动作,移动
consecutive	adj. 连续的,连贯的
collection	n. 收藏品,收集物,小组,集合
front	n.前面； 正面； 身体前部； 前线 adj.前面的； 正面的； 舌前的 v.面向； 在…前面； 用…作正面； 领导
prefix	n. 前缀 vt. 加...作为前缀,置于前面 adj. 前缀的
carousel	n. 旋转木马, （机场的）行李传送带 =carrousel
safety	n.安全； 安全性； 安全处所； 中卫 adj.保障安全的
static	n. 静电, 静电干扰, 噪声, 阻碍, 抨击 adj. 静态的,静电的,固态的