fact	n. 实际, 事实
alter	v. 改变
track	n. 小路, 跑道, 轨道, 踪迹; 惯例, 常规 v. 跟踪, 追踪
precedence	n. 优先, 居先
skeleton	n. 骨架,纲要,骨骼,骨瘦如柴的人或动物,家丑 adj. 骨骼的
log	n. 记录,圆木,日志,计程仪 vt. 伐木,切,记录,航行,度过(时间) vi. 采伐
star	n. 星, 明星 v. 以星状物装饰, 变成演员
hot	adj. 热的,热情的,辣的,性感的 adv. 激动地,快速地 n. 最高温度,滚烫的东西
replaceable	adj. 可置换的，可代替的
accessible	adj. 可得到的, 易接近的, 可进入的
involve	vt. 包含, 使陷入, 使忙于, 使卷入, 牵涉
configure	v. 配置
question	n. 问题,询问,争论点 vt. 询问,怀疑 vi. 问问题
green	adj.绿色的； 未熟的，青春的； 未成熟的； 主张保护环境的 n.绿色蔬菜； 绿色的衣服； 植物 vi.绿化，使重视环境保护问题
entirely	adv. 完全地
helpful	adj. 有帮助的, 有益的
middle	n.中部，中间； 腰部； 中央； 正中 adj.中部的； 中央的； 正中的； 中间的 vt.把…放在中间； 把…对折 vi.放在中间； 对折
declared	adj. 承认的, 公告的 动词declare的过去式和过去分词
compress	vt. 压缩, 压榨 n. [医]敷布
graphically	adv. 用图表表示地
auto	n. autos=automobile 自动汽车 pref. 自动的,自己的
automatic	n. 自动装置, 半自动武器 adj. 自动的,机械的,半自动化的
anywhere	adv. 任何地方 pron. 任何(一个)地方
terminal	n. n. 终端机,终点,末端 adj. 终点的,晚期的,致死的
door	n. 门
expire	vi. 期满,失效,终止,断气 vt. 呼气
resolution	n.决心； 解决； 坚决； 分辨率
local	adj. 地方性的,当地的,局部的 [计算机] 局部的
semicolon	n. 分号
reread	vt.重读,再读
overwrite	v. 重写, 写得过多, 描述过分
critical	adj.批评的，爱挑剔的； 危险的，危急的； 决定性的； [物]临界的
manager	n. 经理
capability	n. 能力,才能,性能,容量
affected	adj. 受到影响的；做作的；假装的 vt. 影响；假装；使…感动（affect的过去式和过去分词）
border	n. 边缘 vt. 作...之疆界,加边
cache	n. 电脑高速缓冲存储器；贮存物；隐藏处 vt. 隐藏；窖藏 vi. 躲藏
bell	n. 钟,铃,花冠,吼叫声 vt. 敲钟,使象钟状地张开 vi. 使呈钟状,张开
play	n. 游戏,游玩,剧本,比赛,比赛中的动作,影响 vt. &vi. 玩,进行比赛,演奏,播放,捉弄,假装
quickly	adv. 快, 迅速
fastback	快速返回
answer	vt.& vi.答复； 解答； 答辩； 适应 n.回答； 答案； 反应； 足以媲美的人
represent	vt. 表现, 表示, 描绘, 代表 vi. 提出异议
difference	n. 差异,分歧 vt. 引起区别
project	n. 工程,项目,计划,事业 v. 计划,设计,表达 v. 投射,放映,凸出
physical	adj. 身体的,物理的,物质的 n. 体检
matter	n. 事件, 物质, 原因 vi. 有关系
hercules	n.大力英雄,力士,武仙座
reduce	vt.换算； 约束； 使变为； 使变弱 vi.减少； 减轻体重； [生物学]（细胞）减数分裂； （液体）浓缩变稠
publisher	n. 出版者, 发行人
trim	n. 整齐,装饰,修剪下来的部分 adj. 整洁的,匀称的 adv. 整齐地 vt. 修除,削剪,装备,痛打,击败, 使整洁 vi. 保持平衡, 见风使舵
substitute	n. 代替者,代用品 v. 代替 vi. (for)代替 vt. 用...代替,代以
disabled	adj. 残废的 n. 残疾人
recent	adj. 近来的, 新近的
positive	adj. 肯定的, 积极的, 绝对的 adj. 正面的, 正数的, 阳性的
upgrade	vt. 提高(上升,浓集,加强) n. 提高(上升,浓集,加强)
instance	n.例子，实例； 情况； 要求，建议； [法]诉讼手续 vt.举…为例
happen	vi. 发生,碰巧,出现,偶然遇到
future	adj. 将来的 n. 将来,未来 n. 期货
midnight	n. 午夜，漆黑
though	adv. 可是,然而,不过 conj. 尽管,虽然 prep. 但.
nor	conj.&adv. 也不,也没有 [计]"或非"，"非或" abbr. 诺曼人(=Norman) abbr. 北方（=North） abbr. 挪威（= Norway） abbr. 挪威人（=Norwegian）
mono	pref. 表示“一”“单一” adj. (唱片等)单声道的 n. 单声道唱片 n. (=infectious mononucleosis) 传染性单核细胞增多症
slide	n. 滑,幻灯片,雪崩,山崩,滑坡,滑梯 vt. 使滑 vi. 滑,跌落
abort	v. 流产, 打胎, 堕胎
jump	n. 跳跃,跳动,上涨 vt. &vi. 跳越,突升,惊跳
toward	prep. 对于,关于,接近,将近,向,朝 adj. 有希望的,有利的,逼近的
throughout	adv. 到处, 自始至终 prep. 遍及, 贯穿
via	prep. 经由
among	prep. 在...之中
neither	adj. 皆不,两者都不 int. 两者都不 conj. 既非,既不
layer	n.层，层次； 膜； [植]压条； 放置者，计划者 vt.把…分层堆放； 借助压条法； 生根繁殖； 将（头发）剪成不同层次 vi.形成或分成层次； [植]通过压条法而生根
scatter	n. 散布, 零星少量 vt. 驱散, 散播 vi. 分散, 消散
attention	n. 注意(力),关心,立正
convention	n.会议； 全体与会者； 国际公约； 惯例，习俗，规矩
conventional	adj. 普通的,常见的,习惯的,常规的
tool	n. 工具,用具,受人利用的人,印压的图案 vt. 驾驶,用工具加工,印压图案于 vi. 驾驶,用工具加工
processor	n. 加工者,处理器
desktop	n. 桌面，台式电脑 adj. 台式的，桌上用的
build	vt. &vi. 建造，创建，开发，逐渐增强 n. 体格，身材
development	n. 发展,显影, 开发区, 开发
exceed	vt. 超过, 胜过, 超出界限 vi. 领先
understand	vt. 理解, 闻知 vi. 理解, 相信, 表示同情
horizontal	adj. 水平的,横的 n. 水平线,水平面
meet	n. 集会,比赛, 运动会 adj. 适宜的,合适的 vt. 遇见,引见,经历,结识,对付,满足,支付 vi. 相遇,集合,交锋,相交
protect	vt. 保护,投保 vi. 提供保护
reserve	n. 预备品, 贮存, 候补 n. 克制, 含蓄 vt. 保留, 预订, 延期
clock	n. 时钟, 计时器
manifest	n. 载货单,运货单,旅客名单 adj. 显然的,明白的 vt. 显示, 证实, 出示
safe	adj. 安全的 n. 保险箱
disconnect	vt. 使分离 vi. 断开，拆开
clockwise	adj. 顺时针方向的 adv. 顺时针方向地
eliminate	v. 除去,排除,剔除 [计算机] 消除
actual	adj. 实际的,真实的
declaration	n. 宣布, 宣言
probably	adv. 大概,或许
ring	n. 环, 戒指, 铃声, 圈 vt. 包围, 挂铃铛 vi. 鸣响, 回响, 在空气中螺旋上扬, 形成圈
cover	n. 封面, 盖子, 表面 v. 覆盖, 涉及, 包含
indicator	n. 指示器, 指示剂 [计算机] 指示符
apple	n. 苹果
icon	n. 肖像, 偶像, 象征, 图符 [计算机] 图标,图符
consideration	n. 考虑, 体贴, 考虑因素, 敬重, 意见
skill	n. 技能, 技巧
picture	n. 图画,照片,景色 vt. 画,描写,想像
layout	n. 布局, 安排, 设计
suggest	vt. 建议,暗示,要求
convenient	adj. 方便的
instruct	v. 教, 命令, 指导 [计算机] 指示
appendix	n. 附录,阑尾
medium	n. 媒体, 方法, 媒介 adj. 适中的, 中等的
truncate	vt. 切去头端，缩短，截棱成平面 adj. 切去了头，缩短了的，截形的
inhibit	vt. &vi. 禁止,抑制 [计算机] 禁止
nearly	adv. 几乎, 差不多
warn	vt. 警告,注意,远离 vi. 提醒
underline	v. 在...下面划线
register	v. 记录, 登记, 注册, 挂号 n. 暂存器, 记录, 登记簿 n. (语)语域; 通风调节设备
stuff	n. 材料, 原料, 东西 n. 素质, 本质; 废物 vt. 填满, 塞满
exclude	vt. 除外,排除,拒绝 [计算机] 排除
destroy	vt. &vi. 破坏,毁坏 [计算机] 撤消
calculation	n. 计算
angle	n. 角(度),角落 vt. 斜移,转变角度 vi. 钓鱼,谋取,转变角度 n. (Angle)盎格鲁人
lexical	adj. 字典的, 语句的
decide	vt. &vi. 决定,作出抉择
trouble	n. 困扰,麻烦,困难,故障 vt.& vi. 困扰,麻烦
customer	n. 顾客，家伙
port	n.港口； （事情的）意义； （计算机与其他设备的）接口； （船、飞机等的）左舷 vt.举枪； 持枪； 左转舵 vi.转向左舷 adj.左舷的，左侧的 vt.& vi.转舵（向左），把（舵）转向左边 adv.向左舷，向左
discuss	vt. 讨论
segment	n. 部分 v. 部分,段,分割 vt. 分割
filing	n. 锉(文件的整理汇集)
market	n. 市场,交易,推销地区 vt. 在市场上交易,使...上市 vi. 在市场上买卖
valuable	adj. 贵重的, 有价值的 n. (pl.)贵重物品
limited	adj. 有限的
trying	vbl. 试验,尝试 adj. 难受的, 费劲的, 令人厌烦的
heap	n. 堆,许多,累积 vt. 使成堆,装满 [计算机] 堆
grey	adj. 灰色的 n. 灰色(的) v. 变成灰色 [=gray] vi. 变成灰色
permanently	adv. 永久地
accelerator	n. 加速器, 油门，[化学]加速剂，促进剂
originally	adv. 本来,原来,最初 重要的
ability	n. 才能, 能力
internally	adv.在内,在中心
derelict	adj. 被抛弃了的,无主的,玩忽职守的 n. 遗弃物,被遗弃的人,玩忽职守者
redirect	adj. 再直接的 v. 重新传入, 重新寄送
reside	v. 住,居留,属于
header	n. 装盖者，割穗机，顶梁，集管 n.[体]头球，头先入水的跳水姿势 n.[计]页眉
extra	adj. 额外的 adv. 特别地 n. 额外的事物，另外收费的
repeated	adj. 重复的, 再之的 动词repeat的过去式和过去分词形式
death	n. 死,死亡，死神，毁灭
observe	v. 观察, 遵守, 注意到
density	n. 密集,密度,透明度
management	n. 管理(层),经营,处理
environmental	adj. 环境的
surrounding	adj. 周围的 n. 环境, 周围的事物
master	n. 主人, 硕士, 母机 adj. 主人的, 主要的 v. 征服, 控制, 精通
recursive	adj. 递归的，循环的
trap	n. 圈套,陷阱,困境,双轮轻便马车 vt. &vi. 设圈套,设陷阱
dimensional	adj.空间的
logic	n. 逻辑(学),逻辑性,合理的推理
conjunction	n. 连词, 结合, 关联,(事件等的)同时发生
identical	adj. 相同的,同一的
advice	n. 忠告，建议，劝告
meaning	n. 意义,意思,含义 adj. 意味深长的
fall	n. 秋天, 落下, 瀑布 v. 倒下, 落下, 来临
interval	n. 间隔,休息时间, (数学)区间, (音乐)音程
compatibility	n. 和谐共处, 兼容
rule	n. 惯例,规则,统治 v. 裁定,统治,支配 vi. 裁决,统治 vt. 统治
flag	n. 旗标,旗子,信号旗 vt. 打旗号 vi. 无力地下垂,减退
criterion	n. 标准, 准则
office	n. 办公室，职务，事务
express	n. 快车, 快递, 专使 adj. 急速的, 明确的, 直接的 adv. 用快递; 特意地 vt. 表达, 表示; 挤压出; 快递
volume	n. 体积, 容量, 音量 n. 卷, 册
soft	adj. 柔软的,温和的,不强烈的,细腻的,轻的 adv. 柔软地,温和地 n. 柔软的东西
activity	n. 活动；行动；活跃
odometer	n. 里程表
phoenix	n. 凤凰, 长生(不死)鸟 引申为重生
obtain	vt. 获得, 得到 vi. 通用, 流行, 存在
easel	n. 画架
latter	adj. 后面的,后者的 pron.&amp;n. 后者
decrease	n. 减少(量),降低 vt.& vi. 减少,降低
mainframe	n. 主机，大型计算机
debugger	[计] 调试器
diacritical	adj. 可区分的 =diacritic
confidential	adj. 机密的,获他人信赖的,易于信任他人的
trace	n. 痕迹,踪迹,微量 vt. 追踪,找出根源,描绘 vi. 追踪
division	n. 区分,分开,除法,公司,部门，师（军队里）
regular	adj. 有规律的,有规则的,整齐的,正规的
implicit	adj. 暗示的,盲从的 [计算机] 隐式
mention	vt.提到，说起； 提名表扬 n.提及
near	adj. 接近的,近亲的,亲近的,勉强的,直接的,小气的,近似的 adv. 接近,几乎,亲近 prep. 靠近 vt. 靠拢,接近 vi. 接近
fifth	num. 第五 n.五分之一
seven	num. 七
whereas	conj.&amp;adv. 然而,却,反之
review	n. 检讨, 复习, 回顾, 评审 vt. 温习, 检讨, 评论, 检阅 vi. 写评论
transform	vt. 转换,变形 vi. 改变 n. 变形
align	vt. 使成一行, 使一致, 使结盟, 调整, 排列 vi. 成一条线
yellow	adj. 黄色的 n. 黄色
assist	n. 帮助,协助,协助的器械 vt. 帮助,协助 vi. 帮助,协助,出席
finish	n. 完成,最后加工,结局,完美 vt. 结束,获...第几名 vi. 终结,完成