micro	adj. 微小的 n. 微米(百万分之一, 测微计)
beyond	adv. 在更远处,另外 n. 远处, 来世 prep. 超出, 越过,另外
against	prep. 反对,倚靠,违背,防御,相比,相对
upon	prep. 在...上
service	n. 服务, 公务部门, 服役, 发球, 发球方式 vt. 维护, 保养
little	adj. 小的 adv. 毫不，少量地 n. 几乎没有（指数量或程度等）
exhaust	n. 排气,排气装置 v. 用尽,耗尽,使...精疲力尽 [计算机] 排除
choice	adj. 上等的,精选的 n. 选择,挑选
sounding	n. 探测水的深度, 试探 adj. 发声的, 夸大的 动词sound的现在分词形式
develop	vt. 发展,开发,冲洗照片 vi. 进步
holding	n. 把持, 支持, 保持 vbl. 握住, 把持, 举行
alpha	n. 希腊字母的第一个字母，最初，开端 adj. [化]阿尔法位的，主导的，首要的，按字母顺序的
constant	adj. 经常的, 不变的 n. 常数, 恒量
warranty	n. 担保,保证,根据
stay	n. 停留,停止;依靠,忍耐力;撑条 vt. 等待,坚持到底 vi. 保持,停留,留宿
industry	n. 工业,产业,勤勉,刻苦
trigger	vt. 引发，引起；触发 vi. 松开扳柄 n. 扳机；[电子] 触发器；制滑机
lesson	n. 课，教训 vt. 给...上课,教训
treat	v. 对待, 治疗，处理，请客，视为 n. 款待，宴飨
busy	adj. 忙的,杂乱的 vt. 使忙于 vi. 忙
usage	n. 惯用法,使用,用法
difficult	adj. 困难的, (人)难取悦的, 难相处的
failure	n. 失败,失败的人或事
communication	n. 沟通,交通
building	n. 建筑物
ally	n. 盟友,同盟国 vt. &vi. 联盟,联合，同盟
exclamation	n. 惊呼, 惊叹词
turning	n. 旋转, 回转, 转向
whole	adj. 整个的, 完全的, 未受损的, (人)全面发展的 n. 全部, 通常情况 adv. 完全地, 统一地
parent	n. 父母,根源 vt. &vi. 抚养,产生
connection	n. 联系,关系,连接,亲戚
connectivity	n. [计算机] 连通性
translation	n. 翻译, 译文
dynamic	adj. 动态的, (有)动力的, (有)力的; 有活力的 n. 动力; 力学
foreground	n. 前景, 最显著的位置
preserve	vt.保护； 保持，保存； 腌制食物； 防腐处理 vi.保鲜； 保持原状； 做蜜饯； 禁猎 n.蜜饯； 防护用品； 禁猎地； 独占的事物（或范围）
vice	n. 恶习,恶行,罪恶,缺陷,恶癖,老虎钳 vt. 钳住 prep. 代替,副,次
necessarily	adv. 必然地,必定地，必需地
circle	n. 圆周,社交圈,循环 vt. &vi. 包围,盘旋,环绕
differ	vi. 不一致,不同(意见)
stationary	adj. 不动的(稳定的) n. 固定物(驻军)
extract	n. 榨出物,精华,摘录 vt. 拔出,榨出,摘录,提取,选取 [计算机] 提取
unrecognized	adj. 未被承认的, 未被认出的
thereafter	adv. 其后, 从那时以后
inverse	adj. 相反的,倒转的 n. 相反的事物,(数学)逆反函数, 倒数, 负数
spell	v. 拼写，缓慢地或吃力地读 n. 魅力，符咒 vt. 用符咒镇住(某人) n. 一段时间，轮班 v. 轮班，休息
limiting	adj. 限制的 动词limit的现在分词
restructure	v. 更改结构, 重建构造
delimit	vt. 定界限, 划界
pay	n. 薪资,付款,报偿 vt. 支付,付清,报偿,给予 vi. 债清，值得，承担后果 adj. 投币的，要钱的
separately	adv. 分别地；分离地；个别地
classify	v. 分类,归类,分等
interfere	vi. 妨碍,冲突,干涉
mind	n. 思想, 主意, 心意, 记忆, vt. 留心, 注意, 介意, 照顾 vi. 留心, 关心
individually	adv. 个别地，单独地，独特地
vertical	adj. 垂直的,顶点的,纵向的 n. 垂直物, 垂直的位置
undesirable	adj. 不受欢迎的, 不良的，不合意的，讨厌的 n. 不受欢迎的人，不良分子
lot	adv. 很,非常 pron. 大量 n. 许多,量,小组,抽签,场地,命运 vt. 分配,划分
piece	n. 块,片,篇 vt. 修补,结合
unavailable	adj. 得不到的, 没空的, 不能利用的
unlike	adj. 不同的, 不相似的 prep. 不像, 和...不同
sit	vt. 坐,担任,开会,孵 vi. 坐,孵 n. 坐
insufficient	adj. 不足的
map	n. 地图 v. 映射,绘制...之地图,计划 [计算机] 存储区分配图
figure	n. 图形, 数字, 形状; 人物, 外形, 体型 v. 演算, 认为, 领会到
prepare	vt.准备； 预备（饭菜）； 配备； 使（自己）有准备 vt.& vi.筹备，进行各项准备工作； 做好思想准备； 作出，制订； 锻炼（身体等），训
consider	vt. 考虑, 思考, 认为
detect	vt. 发现,探测信息,侦查 vi. 当侦探
convenience	n. 适宜，便利, 便利设施，方便的时间，舒适
method	n. 方法,办法,条理
mean	n.平均值, 平均数; 中部 adj. 低劣的, 卑贱的; 卑鄙的; 吝啬的 adj. 平均的, 中等的 v. 意味, 想要, 意欲
salary	n. 薪水 vt. 给...薪水
pacific	adj. 太平洋的,(pacific)热爱和平的,求和的, 和解的 n. 太平洋
strong	adj. 强壮的, 牢固的, 坚定的, 坚强的, 强烈的, 浓的
emphasize	v. 强调,着重 vt. 强调
department	n. 部,部门,系
forced	adj. 被迫的, 强迫的, 用力的，不自然的 force的过去式(分词）
ANSI	abbr. 美国国家标准学会(=American National Standards Institute)
permanent	adj. 永久的, 持久的 n. (口)烫发
remark	n. 备注,评论,注意 vt. 评论,注意,述及
away	adv. 远离,离开,出去,连续的,遥远地
concatenate	v. 连结,连锁 adj. 连锁的
lightning	n. 闪电 adj. 闪电般的, 快速的 vi. 打闪
additionally	adv. 另外(加之, 又)
emulate	vt. 效法, 尽力赶上, 仿真 [计算机] 仿真
tape	n. 录像带, 录音带, 磁带, 胶带 vt. 用带子捆起, 给...录音 vi. 录音
concept	n. 概念, 观念
optimize	v. 使...完美,乐观,使...完善 v.优化
counter	n. 计算器,计算者,柜台 [计算机] 计数器 adj. 相反的 adv. 与…相反地 vt. 反对,反击 vi. 反对,反击
expect	vt.期望； 预料； 要求； 认为（某事）会发生 vi.预期； 期待； 怀胎； 怀孕
subsequently	adv. 后来, 随后
registration	n. 登记,注册,挂号
city	n. 城市
designate	adj. 指定的 vt. 指定,选派,标明
visible	adj. 可见的, 看得见的
consult	v. 商讨,向...请教,查阅
completely	adv. 完全地, 十分地, 全然
virtually	adv. 几乎,实际上
substantially	adv. 实质上,本质上,大体上
specialize	vi.专门从事； 专攻； 详细说明； 特化 vt.使专门化； 使适应特殊情况； 详细说明； 列举
fail	vi. 衰退,失败,不及格 vt. 辜负,缺少,未能做 n. 不及格
primarily	adv. 首先, 主要地
client	n.顾客； 当事人； 诉讼委托人； [计算机]客户端
runtime	[计] 运行时间
fix	vt. &vi. 使...固定,修理,准备 n. 困境, (船只、飞机等的)定方位,贿赂
author	n. 作者,创造者 vt. 创造,写作
programmer	n.程序员, 程序规划员 ,节目编排者 =programer（英）
commercial	adj. 商业的 n. 商业广告
particularly	adv. 特别, 尤其
low	n. 低,低点(价),深度,牛叫声 adj. 低的,消沉的,低等的,粗俗的,衰弱的 vi. 牛叫
sheet	n. 床单,张,片 vt. 盖上被单,遍布, 使成片状 vi. 成片落下或流动 adj. 片状的
employee	n. 雇员
legal	adj. 法律的,合法的,法定的
qualified	adj. 有资格的 vbl. 取得资格
context	n. 上下文, 环境,背景
involved	v. 涉及(包含,遍及,占用,促成,自乘) adj. 所包含的(形式复杂的)
conditional	adj. 有条件的, 假定的，假设的 n. [语]条件句
halfway	adj. 中途的, 不彻底的 adv. 半路地, 在中途
oriented	adj. 导向的,定向的
pair	n. 双,对,副 vt.& vi. 使...成对,配对
week	n. 星期, 周
subroutine	n. [计算机]子程序
bracketed	
manually	adv.用手
preset	vt. 预先装置，事先调整
autoindex	adj.[计]自动索引,自动变址
restrict	v. 限制,约束
performance	n.表演； 演技； 表现； 执行
showing	n. 显示, 放映 动词show的现在分词
ever	adv. 曾经, 永远, 究竟
distribution	n. 分发, 分配, 散布, 分布
denote	vt. 象征,表示
cash	n. 现金 vt. 兑现,付现款 adj. 现金的
repeatedly	adv. 重复地, 再三地
replicate	vt. &vi. 折叠,复制,模写 n. 同样的样品 adj. 转折的
mega	兆, 百万
conform	vt. 使一致,遵守,使顺从 vi. 一致,符合
rebuild	v. 重建，改建，使复原
certainty	n. 确定, 确实的事情
controller	n. 控制器, 管理者, 主计员
pseudo	adj. 假的, 冒充的
manage	vt. 管理,处理,维持,达成,经营 vi. 管理,达成