administrator	n. 管理人,行政官
ensemble	n. 全体, 合唱曲, 女人的全套服装
bus	n. 公共汽车
allowable	adj. 容许的, 承认的
restriction	n. 限制,约束 vi. 结果,(作为结果)发生
height	n. 高度,高处,身高, 最高峰, 极点
remainder	n. 剩余物, 其他的人, 残余 vt. 廉价出售 adj. 剩余的
traverse	n. 横贯, 横木 v. 横过, 铭刻
organization	n. 机构,组织 adj. 有组织的
resulting	adj.作为结果的,因而发生的
solution	n. 解答, 解决办法, 溶解, 溶液
external	n. 外部 adj. 外部的,外用的,客观的,表面的
adequate	adj. 足够的, 充足的, 适当的, 能胜任的
vary	vt. 改变,使多样化 vi. 变化,违背
gap	n. (意见、个性等的)差异,缝隙,漏洞,缺口 vt. 制造缺口 嘉普(财富500强公司之一，总部所在地美国,主要经营服装零售)
indexing	n. 指数(分度, 索引, 转位, 转换角度, 换档, 改址)
board	n. 木板, 甲板, 董事会 n. 伙食; 舞台, 演员的职业; 船舷 vt. 登(飞机、车、船等); 有偿提供食宿; 用木板覆盖 vi. 搭伙
package	n. 包裹,整批交易 vt. 把...打包,把...进行推销
insertion	n. 插入,刊载,插入物
intervene	vi. 插入,介入,干涉,调停 [计算机] 介入
conflict	n.冲突； 战斗； 相互干扰； 矛盾 vi.抵触； 争斗； 战斗； 冲突
really	adv. 真正地,实在，事实上
overflow	n. 溢值,超值,泛滥 v. 泛滥,溢出,充溢 [计算机] 溢出
charge	n. 电荷, 指控, 费用; 照顾, 责任 vt. &vi 控诉, 加罪于, 要价, 赊帐, 充电, 管理
phone	n. 音位,电话,耳机 vt. &vi. 打电话
virtual	adj. 虚拟的；有效的；实质上的，事实上的
compose	vt. 组成, 写作, 作曲, 使镇静 vi. 创作
snapshot	n. 快照，印象
sensitivity	n. 敏感, 多愁善感, 感受性
familiar	adj. 熟悉的,熟知的,不拘礼节的 n. 熟人,熟悉某种事物的人
Mach	n. [物]马赫（速度单位） n. 马赫(奥地利物理学家, 心理学家、哲学家) abbr. 机器（=machine）
incorrect	adj. 不正确的, 错误的
cut	n. 切口,割伤,降低,份额,删节,割下的一块肉 vt. 切割,减少,停止,修剪 vi. 切割,快速移动 [计算机] 剪掉
lowest	adj.最低的,最底下的,最小的
simple	adj. 简单的,无辜的,天真的,基本的,纯粹的 n. 平民,精神病人,草药
subsequent	adj. 随后的,后来的
compact	adj. 紧凑的,紧密的,简洁的 v. 使装满,使简洁
plain	n. 平原,草原 adj. 简单的,平坦的,平常的,家常的 adj.纯的，不掺杂的
noted	adj. 著名的，有声望的 动词note的过去式和过去分词形式
desirable	adj. 值得有的,令人满意的,有吸引力的 n. 有吸引力的人
substitution	n. 代理,替换,交换
consume	vt. 消耗，毁灭，吃，喝, 挥霍 vi. 耗尽生命, 被烧毁
forget	vt. &vi. 忘记,忽略
keyed	v.键入 vbl.键入
tornado	n. 飓风,旋风,龙卷风
quotation	n. 1．引语,语录 2．报价单 3．行情表
parse	v.&amp;n. 从语法上分析
experience	n. 经历, 经验 vt. 经历, 体验
manufacture	n. 产品,制造,制造业 vt. 制造,加工 vi. 参与制造
hundred	n. 百,百个东西 adj. 百,百个
thousand	adj. 千,成千
twentieth	n. 二十分之一 num.&amp;adj. 第二十
understanding	n. 了解, 理解, 个人见解, 非正式协议, 谅解, 同情心, 洞察力 adj. 有同情心的
hand	n. 手,掌握,协助 vt. 帮助,给 adv. 手动地,人工地
fancy	n. 想像力, 幻想, 喜好, 爱 adj. 想像的, 时髦的, 华丽装饰的, 奢侈的, 技巧的 vt. 想象, 自认为, 喜好
wide	adj. 广泛的,宽阔的 adv. 广大地,全部地
fine	n. 罚款,罚金,结尾 vt. 罚款 vi. 净化，细化 adj. 美好的, 优质的, 精致的，晴朗的, 健康的，纤细的，恭维的，辞藻华丽的 adv. 恰好地，合适地
worry	n. 烦恼,忧虑,苦恼 vt. 使...烦恼,使...焦虑, 叼住某物甩或拉 vi. 感到苦恼,感到焦虑
quiet	n. 安静,闲适,平静 adj. 安静的,静止的,宁静的 adv. 安静地 vt. &vi. 使...平静,使...安心
purge	n. 整肃,清除,泻药,净化 vt. 净化,清除,摆脱 vi. 清除,通便,腹泻,变得清洁
mod	abbr. (=modern) 现代的，时髦的 abbr. (=modulus) 模数，绝对值
numeral	adj. 数字的, 表示数字的 n. 数字, 数
whichever	adj. 无论哪个, 无论哪些 pron. 无论哪个
purchase	n. 购买, 购买的物品 n. 支点; 紧握, 抓紧 vt. 购买, 赢得; (用设备)举起, 移动
care	n. 小心,照料,忧虑，慎思，焦虑因素 vi. 关心,照顾,喜爱 vt. 介意,希望 abbr.=Cooperative for American Remittances to Europe 汇款到欧洲合作社
watch	n. 手表,注视 vt. 观察,监视,注视,照顾,等待 vi. 留意,观察
endeavor	n. 努力, 尽力, 进取心 vt. 努力,尽力 vi. 企图, 谋求
mismatch	vt. 配错, 配合不当 n. 配错, 不相匹配
printout	n. (电脑)打印输出
ellipsis	n. 省略
ship	n. 船,舰,船员,飞船 vt. 以船运送,乘船,运送,进水,在船上工作 vi. 上船,坐船,运送,在船上工作
British	adj. 英国的 n. 英国人, 英国英语
parallel	adj. 平行的,相同的,类似的,并联的 adv. 平行地 n. 平行线(面),相似物,对比 vt. 相比,相应,与...平行
custom	n. 习惯, 风俗, 海关
congratulation	n. 祝贺
protection	n. 保护,防卫
glass	n. 玻璃, 玻璃器皿, 窗户, (复)眼镜,透镜 vt. 用玻璃把…盖（或罩、围）住,给...装上玻璃, 使成玻璃状, 反映, 反射, 审视 vi. 成为玻璃状, 用光学仪器眺望
pattern	n. 图案, 式样, 典范 v. 以图案装饰; 仿造, 模仿
insure	vt. 保险,确保 vi. 买保险
factory	n. 工厂, 制造场所
implement	n. 工具, 器具; 当工具的物品 vt. 实施, 执行; 向...提供工具(或手段)
effort	n. 努力, 努力的成果
worker	n. 工人，工作者
ampersand	n. 和，＆(and 的符号）
deal	n. 交易,协定,份量 v. (dealt,dealt[delt])处理,应付,分配
power	n. 力量, 权力，电力 vt. 供电，激励，全速前进 adj. 与力量有关的，与权力有关的，电力控制的
difficulty	n. 困难，争议，反对，麻烦
lose	vt. 遗失,损失,失败,摆脱 vi. 丢失,失败 [计算机] 失去
magic	adj. 有魔力的, 神奇的 n. 魔法, 魔术 vt. 使用魔(变出等)
proprietary	adj. 专利的, 所有权的 n. 所有权, 所有人
aware	adj. 知道的, 意识到的
numerous	adj. 为数众多的,许多
vowel	n. 母音, 元音
closely	adv. 紧密地，接近地，严密地
accuracy	n. 准确(性), 精确度
traditional	adj. 传统的
synchronization	n.同步化
fragment	n. 碎片 vt. &vi. 变成碎片 [计算机] 碎片
primary	n. 最主要者 adj. 主要的, 初期的, 根本的
safely	adv. 安全地
habit	n. 习惯，习性；嗜好 vt. 使穿衣
comprise	vt. 包含,构成
landler	n.兰德勒舞(奥地利农村的民间舞),兰德勒舞曲
absence	n. 没有；缺乏；缺席；不注意
revolutionize	vt. 使革命化，使彻底变革 vi. 变革 =revolutionise（英）
constantly	adv. 不断地,经常地
seldom	adv. 很少 adj. 很少的
unfortunately	adv. 不幸地
expunge	v. 擦掉, 删掉, 除去
security	n.安全； 保证，担保； 保护，防护； 有价证券 adj.安全的，保安的，保密的
touch	n. 触觉,接触,少许, 痕迹, 修饰 vt. 触摸,吃,喝,触及,感动 vi. 接触, 联系
contrast	n.对比，对照； 差异； 对照物，对立面； [摄]反差
invent	v. 发明 vt. 发明,创造
reflect	v. 反映, 反射, 归咎
undone	adj. 未完成的，未做完的 动词undo的过去分词形式
unshift	vi. 松开打字机或键盘的字型变换键
complex	adj. 复杂的 n. 复合体
management	n. 管理(层),经营,处理