complexity	n. 复杂，复杂性, 复杂的事物
creation	n. 创造, 创作
unknown	adj. 未知的，不出名的
greatly	adv. 很, 非常
cost	n.价钱，代价； 花费，费用； 牺牲； [用复数][法律]诉讼费 vi.价钱为，花费； 估计成本 vt.付出代价； 估价； 使丧失； 使付出努力
degrade	vt. 贬低；使……丢脸；使……降级；使……降解 vi. 降级，降低；退化
suggestion	n. 建议, 意见, 迹象, 暗示, 联想
real	adj. 实际的,现实的,真的,真实的 adv. 非常 n. 真实的事, 真实
experimentation	n. 实验, 试验
experiment	n. 实验,试验,尝试 vi. 做实验,尝试
substantial	n. 重要部份, 本质 adj. 大量的, 实质上的, 有内容的
solely	adv. 独自地,单独地
announce	vi.宣布参加竞选； 当播音员 vt.宣布； 述说； 声称； 预告
squeeze	n. 压榨,榨出的少量,佣金,经济拮据 vt. 紧握,挤压,使经济困难 vi. 让步,压迫,险胜
distribute	vt. &vi. 分配,散布
negate	v. 否定, 否认, 打消
capture	n. 抓取,战利品,捕获之物 vt. 抓取,获得,迷住
father	n. 父亲,鼻祖 vt. 作为父亲生育子女 vi. 像父亲般照顾
reinstate	v. 恢复(原职) vt. 使恢复原有的职位
tutorial	n. 个别指导 adj. 个别指导的
nicety	n. 精确，谨慎，精细，细微的区别
roll	vt.辗； 使（眼球等）左右转动； （使）原地转圈； 滚动 vi.左右摇晃； 翻滚； 开始移动，启动 n.名册； 滚翻
exponent	n. 拥护者，说明者，楷模 n. 指数 n. 能手，大师 adj. 说明的
exponential	adj. 指数的 n. 指数
prefer	vt.更喜欢； 提升，提拔； 给予（债权人）优先权； 提出（控告） vi.更喜欢，宁愿
complicated	adj. 复杂的, 难懂的
reactivate	v. 使重新活跃，恢复活动
spread	n. 传布, 伸展 adj. 扩延的 v. 传布, 推广, 伸出
synchronize	v. 使同时, 同时发生
formation	n. 构造,编队,形成
widely	adv. 广泛地
comma	n. 逗号，停顿，间歇 n. 银纹多角蛱蝶
very	adj. 真正的,完全的,自己的,仅仅的,同一个,特别的 adv. 真的,非常
unnecessary	adj. 不必要的,多余的 n. 不必要的东西
unchanged	adj. 无变化的
cross	n. 十字架,十字架形物件,交叉,交叉路 adj. 生气的,交叉的 vt. 划叉剔除，画横线于 vi. 穿越 prep. 穿过
yet	adv. 还,仍然，即刻 conj. 尽管，然而
slowly	adj. 慢慢地 adv. 缓慢地
inexperienced	adj. 无经验的, 不熟练的
unwanted	adj. 不必要的, 空闲的
unused	adj. 未用过的，不习惯的
unmarked	adj. 无记号的, 未被注意的
nothing	adv. 毫不 n. 微不足道的人或事 pron. 什么也没有
chart	n. 图表 vt. 制成图表
dearly	adv. 深深地, 真挚地，昂贵地
extremely	adv. 极其, 非常
hardly	adv. 几乎不
placement	n. 方位,位置,找工作,安排
think	vt.想； 思索； 以为； 看待 vi.思辩； 考虑； 构想； 回忆 adj.深思的； 供思考的 n.想； 想法
technical	adj. 工艺的, 技术的
idea	n. 主意, 想法, 观念
stamp	n. 印,邮票,打印器 vt. 捺印,顿足,贴上邮票
equation	n. 相等,方程(式),等式,均衡
smooth	adj. 平稳的,流畅的,安祥的,圆滑的,搅拌均匀的 vt. 使光滑,磨光,安慰,理顺(羽毛) vi. 变光滑
attached	adj. 附加的, 固定的
average	n. 平均数,平均水平 adj. 一般的,通常的,平均的 vt. &vi. 取平均值，达到平均水平
quietly	adj. 寂静地, 静止地 adv. 安静地, 平静地
discard	n. 丢牌,废牌 vt. 丢弃,抛弃 vi. 丢牌
never	adv. 从不,绝不
initiate	n. 创始人 adj. 新加入的 vt. 开始,创始,启蒙,介绍加入
powerful	adj. 强有力的
purpose	n. 目的, 意图; 意志, 决心; 议题 vt. 打算, 决意
regard	vt.认为； 注视； 涉及； 尊敬 vi.凝视； 留意 n.凝视； 留意； 尊敬； 问候
daily	adj. 每日的, 按天计算的, 日常的 adv. 每日,天天 n. 日报, (复)工作样片
possibly	adv. 可能地, 也许
potentially	adv. 潜在地
moreover	adv.再者； 此外； 而且； 同时
American	adj. 美国的, 美式的 n. 美国人, 美式英语
guard	n. 守卫者,警戒, 护卫队, 保护 vt. &vi. 保卫,看守,警惕
world	n. 世界(人),领域,俗世
independent	adj. 独立的, 自主的，私立的，无偏见的 n. 独立派人士, 无党派者
independently	adv.独立地,自立地
continuously	adv.不断地,连续地
shield	n. 盾,防卫物,盾状物 vt. 保护,遮蔽
glance	vi.一瞥； 闪微光； 掠过，擦过； 随便提到，简略地触及 n.浏览； 闪光； 歪斜，一掠
happening	n. 偶然发生的事 动词happen的现在分词形式
transaction	n. 交易,处理,办理
emulation	n. 效法, 竞争，模仿
strike	n. 罢工, 打击, 殴打 v. 打, 撞, 罢工, 划燃
dump	n. 垃圾场,堆放处 vt. 丢弃,抛售,导出 vi. 骤降,扔垃圾
occasionally	adv. 偶尔地
tension	n. 紧张,张力,拉力 vt. （使金属线、帆等）拉紧
probable	adj. 很可能的 n. 很可能的事
talent	n. 才能, 人才, 天资
financial	adj. 金融的,财政的
meter	n. 公尺,韵律,计量器 vt. 用表测量[计量, 记录]
logged	adj. 记录的, 进水的, 锯成圆木的，沉重的 动词log的过去式及过去分词形式
ware	n. 制品,器具,货物 vt. 留心,意识到 adj. 知道的,意识到的
disregard	n. 不理会, 漠视 vt. 忽视, 不顾
waiting	n. 等候 adj. 候补 动词wait的现在分词
preceding	adj. 在前的,在先的
comparison	n. 比较
advanced	adj. 高级的, 先进的
rate	n. 比率, 等级, 价格 vt. 估价, 认为, 定等级; 责骂 vi. 受欢迎, 受推崇; 责骂
fly	n. 苍蝇,两翼昆虫,飞行,升高 vt. &vi. 飞,飞翔,逃走,飞逝,猛然移动
programmable	adj. 可编程的
definable	adj. 可定义的, 可确定的
readable	adj. 字迹易辨认的 adj. 可读的, 易读的, 读起来津津有味的
recoverable	adj. 可恢复的，可收回的
possibility	n. 可能性,可能的事情,潜在的价值
finisher	n. 运动中最后一击者，修整机(精整工)
applicable	adj. 合适的,适用的
printable	可印刷的
executable	adj.实行的,执行的
essentially	adv. 本质上,本来
confuse	vt. 混乱,狼狈,困惑
familiarize	vt. 使熟悉
employe	(=employee) n.雇工,从业员
suitable	adj. 合适的, 适宜的
generation	n. 代, 一代
instruction	n. 说明,须知,指令,教学